,Rank,Nation,Gold,Silver,Bronze,Total,year,season,host_country
0,1,Norway,4,7,6,17,1924,Winter,France
1,2,Finland,4,4,3,11,1924,Winter,France
2,3,Austria,2,1,0,3,1924,Winter,France
3,4,Switzerland,2,0,1,3,1924,Winter,France
4,5,United States,1,2,1,4,1924,Winter,France
5,6,Great Britain,1,1,2,4,1924,Winter,France
6,7,Sweden,1,1,0,2,1924,Winter,France
7,8,Canada,1,0,0,1,1924,Winter,France
8,9,France,0,0,3,3,1924,Winter,France
9,10,Belgium,0,0,1,1,1924,Winter,France
10,1,United States,45,27,27,99,1924,Summer,France
11,2,Finland,14,13,10,37,1924,Summer,France
12,3,France,13,15,10,38,1924,Summer,France
13,4,Great Britain,9,13,12,34,1924,Summer,France
14,5,Italy,8,3,5,16,1924,Summer,France
15,6,Switzerland,7,8,10,25,1924,Summer,France
16,7,Norway,5,2,3,10,1924,Summer,France
17,8,Sweden,4,13,12,29,1924,Summer,France
18,9,Netherlands,4,1,5,10,1924,Summer,France
19,10,Belgium,3,7,3,13,1924,Summer,France
20,11,Australia,3,1,2,6,1924,Summer,France
21,12,Denmark,2,5,2,9,1924,Summer,France
22,13,Hungary,2,3,4,9,1924,Summer,France
23,14,Yugoslavia,2,0,0,2,1924,Summer,France
24,15,Czechoslovakia,1,4,5,10,1924,Summer,France
25,16,Argentina,1,3,2,6,1924,Summer,France
26,17,Estonia,1,1,4,6,1924,Summer,France
27,18,South Africa,1,1,1,3,1924,Summer,France
28,19,Uruguay,1,0,0,1,1924,Summer,France
29,20,Austria,0,3,1,4,1924,Summer,France
30,20,Canada,0,3,1,4,1924,Summer,France
31,22,Poland,0,1,1,2,1924,Summer,France
32,23,Haiti,0,0,1,1,1924,Summer,France
33,23,Japan,0,0,1,1,1924,Summer,France
34,23,New Zealand,0,0,1,1,1924,Summer,France
35,23,Portugal,0,0,1,1,1924,Summer,France
36,23,Romania,0,0,1,1,1924,Summer,France
37,1,Norway,6,4,5,15,1928,Winter,Switzerland
38,2,United States,2,2,2,6,1928,Winter,Switzerland
39,3,Sweden,2,2,1,5,1928,Winter,Switzerland
40,4,Finland,2,1,1,4,1928,Winter,Switzerland
41,5,Canada,1,0,0,1,1928,Winter,Switzerland
42,5,France,1,0,0,1,1928,Winter,Switzerland
43,7,Austria,0,3,1,4,1928,Winter,Switzerland
44,8,Belgium,0,0,1,1,1928,Winter,Switzerland
45,8,Czechoslovakia,0,0,1,1,1928,Winter,Switzerland
46,8,Germany,0,0,1,1,1928,Winter,Switzerland
47,8,Great Britain,0,0,1,1,1928,Winter,Switzerland
48,8,Switzerland,0,0,1,1,1928,Winter,Switzerland
49,1,United States,22,18,16,56,1928,Summer,Netherlands
50,2,Germany,10,7,14,31,1928,Summer,Netherlands
51,3,Finland,8,8,9,25,1928,Summer,Netherlands
52,4,Sweden,7,6,12,25,1928,Summer,Netherlands
53,5,Italy,7,5,7,19,1928,Summer,Netherlands
54,6,Switzerland,7,4,4,15,1928,Summer,Netherlands
55,7,France,6,10,5,21,1928,Summer,Netherlands
56,8,Netherlands,6,9,4,19,1928,Summer,Netherlands
57,9,Hungary,4,5,0,9,1928,Summer,Netherlands
58,10,Canada,4,4,7,15,1928,Summer,Netherlands
59,11,Great Britain,3,10,7,20,1928,Summer,Netherlands
60,12,Argentina,3,3,1,7,1928,Summer,Netherlands
61,13,Denmark,3,1,2,6,1928,Summer,Netherlands
62,14,Czechoslovakia,2,5,2,9,1928,Summer,Netherlands
63,15,Japan,2,2,1,5,1928,Summer,Netherlands
64,16,Estonia,2,1,2,5,1928,Summer,Netherlands
65,17,Egypt,2,1,1,4,1928,Summer,Netherlands
66,18,Austria,2,0,1,3,1928,Summer,Netherlands
67,19,Australia,1,2,1,4,1928,Summer,Netherlands
68,19,Norway,1,2,1,4,1928,Summer,Netherlands
69,21,Poland,1,1,3,5,1928,Summer,Netherlands
70,21,Yugoslavia,1,1,3,5,1928,Summer,Netherlands
71,23,South Africa,1,0,2,3,1928,Summer,Netherlands
72,24,India,1,0,0,1,1928,Summer,Netherlands
73,24,Ireland,1,0,0,1,1928,Summer,Netherlands
74,24,New Zealand,1,0,0,1,1928,Summer,Netherlands
75,24,Spain,1,0,0,1,1928,Summer,Netherlands
76,24,Uruguay,1,0,0,1,1928,Summer,Netherlands
77,29,Belgium,0,1,2,3,1928,Summer,Netherlands
78,30,Chile,0,1,0,1,1928,Summer,Netherlands
79,30,Haiti,0,1,0,1,1928,Summer,Netherlands
80,32,Philippines,0,0,1,1,1928,Summer,Netherlands
81,32,Portugal,0,0,1,1,1928,Summer,Netherlands
82,1,United States,6,4,2,12,1932,Winter,USA
83,2,Norway,3,4,3,10,1932,Winter,USA
84,3,Sweden,1,2,0,3,1932,Winter,USA
85,4,Canada,1,1,5,7,1932,Winter,USA
86,5,Finland,1,1,1,3,1932,Winter,USA
87,6,Austria,1,1,0,2,1932,Winter,USA
88,7,France,1,0,0,1,1932,Winter,USA
89,8,Switzerland,0,1,0,1,1932,Winter,USA
90,9,Germany,0,0,2,2,1932,Winter,USA
91,10,Hungary,0,0,1,1,1932,Winter,USA
92,1,United States,41,32,30,103,1932,Summer,USA
93,2,Italy,12,12,12,36,1932,Summer,USA
94,3,France,10,5,4,19,1932,Summer,USA
95,4,Sweden,9,5,9,23,1932,Summer,USA
96,5,Japan,7,7,4,18,1932,Summer,USA
97,6,Hungary,6,4,5,15,1932,Summer,USA
98,7,Finland,5,8,12,25,1932,Summer,USA
99,8,Great Britain,4,7,5,16,1932,Summer,USA
100,9,Germany,3,12,5,20,1932,Summer,USA
101,10,Australia,3,1,1,5,1932,Summer,USA
102,11,Argentina,3,1,0,4,1932,Summer,USA
103,12,Canada,2,5,8,15,1932,Summer,USA
104,13,Netherlands,2,5,0,7,1932,Summer,USA
105,14,Poland,2,1,4,7,1932,Summer,USA
106,15,South Africa,2,0,3,5,1932,Summer,USA
107,16,Ireland,2,0,0,2,1932,Summer,USA
108,17,Czechoslovakia,1,2,1,4,1932,Summer,USA
109,18,Austria,1,1,3,5,1932,Summer,USA
110,19,India,1,0,0,1,1932,Summer,USA
111,20,Denmark,0,3,3,6,1932,Summer,USA
112,21,Mexico,0,2,0,2,1932,Summer,USA
113,22,Latvia,0,1,0,1,1932,Summer,USA
114,22,New Zealand,0,1,0,1,1932,Summer,USA
115,22,Switzerland,0,1,0,1,1932,Summer,USA
116,25,Philippines,0,0,3,3,1932,Summer,USA
117,26,Spain,0,0,1,1,1932,Summer,USA
118,26,Uruguay,0,0,1,1,1932,Summer,USA
119,1,Norway,7,5,3,15,1936,Winter,Germany
120,2,Germany,3,3,0,6,1936,Winter,Germany
121,3,Sweden,2,2,3,7,1936,Winter,Germany
122,4,Finland,1,2,3,6,1936,Winter,Germany
123,5,Switzerland,1,2,0,3,1936,Winter,Germany
124,6,Austria,1,1,2,4,1936,Winter,Germany
125,7,Great Britain,1,1,1,3,1936,Winter,Germany
126,8,United States,1,0,3,4,1936,Winter,Germany
127,9,Canada,0,1,0,1,1936,Winter,Germany
128,10,France,0,0,1,1,1936,Winter,Germany
129,10,Hungary,0,0,1,1,1936,Winter,Germany
130,1,Germany,38,31,32,101,1936,Summer,Germany
131,2,United States,24,21,12,57,1936,Summer,Germany
132,3,Hungary,10,1,5,16,1936,Summer,Germany
133,4,Italy,9,13,5,27,1936,Summer,Germany
134,5,Finland,8,5,6,19,1936,Summer,Germany
135,6,France,7,6,6,19,1936,Summer,Germany
136,7,Sweden,6,5,10,21,1936,Summer,Germany
137,8,Japan,6,4,10,20,1936,Summer,Germany
138,9,Netherlands,6,4,7,17,1936,Summer,Germany
139,10,Austria,5,7,5,17,1936,Summer,Germany
140,11,Switzerland,4,9,5,18,1936,Summer,Germany
141,12,Great Britain,4,7,3,14,1936,Summer,Germany
142,13,Czechoslovakia,3,5,1,9,1936,Summer,Germany
143,14,Argentina,2,2,3,7,1936,Summer,Germany
144,14,Estonia,2,2,3,7,1936,Summer,Germany
145,16,Egypt,2,1,2,5,1936,Summer,Germany
146,17,Canada,1,3,5,9,1936,Summer,Germany
147,18,Norway,1,3,2,6,1936,Summer,Germany
148,19,Turkey,1,0,1,2,1936,Summer,Germany
149,20,India,1,0,0,1,1936,Summer,Germany
150,20,New Zealand,1,0,0,1,1936,Summer,Germany
151,22,Poland,0,4,5,9,1936,Summer,Germany
152,23,Denmark,0,2,3,5,1936,Summer,Germany
153,24,Latvia,0,1,1,2,1936,Summer,Germany
154,25,Romania,0,1,0,1,1936,Summer,Germany
155,25,South Africa,0,1,0,1,1936,Summer,Germany
156,25,Yugoslavia,0,1,0,1,1936,Summer,Germany
157,28,Belgium,0,0,3,3,1936,Summer,Germany
158,28,Mexico,0,0,3,3,1936,Summer,Germany
159,30,Australia,0,0,1,1,1936,Summer,Germany
160,30,Philippines,0,0,1,1,1936,Summer,Germany
161,30,Portugal,0,0,1,1,1936,Summer,Germany
162,1,United States,38,27,19,84,1948,Summer,England
163,2,Sweden,16,11,17,44,1948,Summer,England
164,3,France,10,6,13,29,1948,Summer,England
165,4,Hungary,10,5,12,27,1948,Summer,England
166,5,Italy,8,11,8,27,1948,Summer,England
167,6,Finland,8,7,5,20,1948,Summer,England
168,7,Turkey,6,4,2,12,1948,Summer,England
169,8,Czechoslovakia,6,2,3,11,1948,Summer,England
170,9,Switzerland,5,10,5,20,1948,Summer,England
171,10,Denmark,5,7,8,20,1948,Summer,England
172,11,Netherlands,5,2,9,16,1948,Summer,England
173,12,Great Britain,3,14,6,23,1948,Summer,England
174,13,Argentina,3,3,1,7,1948,Summer,England
175,14,Australia,2,6,5,13,1948,Summer,England
176,15,Belgium,2,2,3,7,1948,Summer,England
177,16,Egypt,2,2,1,5,1948,Summer,England
178,17,Mexico,2,1,2,5,1948,Summer,England
179,18,South Africa,2,1,1,4,1948,Summer,England
180,19,Norway,1,3,3,7,1948,Summer,England
181,20,Jamaica,1,2,0,3,1948,Summer,England
182,21,Austria,1,0,3,4,1948,Summer,England
183,22,India,1,0,0,1,1948,Summer,England
184,22,Peru,1,0,0,1,1948,Summer,England
185,24,Yugoslavia,0,2,0,2,1948,Summer,England
186,25,Canada,0,1,2,3,1948,Summer,England
187,26,Portugal,0,1,1,2,1948,Summer,England
188,26,Uruguay,0,1,1,2,1948,Summer,England
189,28,Ceylon,0,1,0,1,1948,Summer,England
190,28,Cuba,0,1,0,1,1948,Summer,England
191,28,Spain,0,1,0,1,1948,Summer,England
192,28,Trinidad And Tobago,0,1,0,1,1948,Summer,England
193,32,Panama,0,0,2,2,1948,Summer,England
194,32,South Korea,0,0,2,2,1948,Summer,England
195,34,Brazil,0,0,1,1,1948,Summer,England
196,34,Iran,0,0,1,1,1948,Summer,England
197,34,Poland,0,0,1,1,1948,Summer,England
198,34,Puerto Rico,0,0,1,1,1948,Summer,England
199,1,Norway,4,3,3,10,1948,Winter,Switzerland
200,1,Sweden,4,3,3,10,1948,Winter,Switzerland
201,3,Switzerland,3,4,3,10,1948,Winter,Switzerland
202,4,United States,3,4,2,9,1948,Winter,Switzerland
203,5,France,2,1,2,5,1948,Winter,Switzerland
204,6,Canada,2,0,1,3,1948,Winter,Switzerland
205,7,Austria,1,3,4,8,1948,Winter,Switzerland
206,8,Finland,1,3,2,6,1948,Winter,Switzerland
207,9,Belgium,1,1,0,2,1948,Winter,Switzerland
208,10,Italy,1,0,0,1,1948,Winter,Switzerland
209,11,Czechoslovakia,0,1,0,1,1948,Winter,Switzerland
210,11,Hungary,0,1,0,1,1948,Winter,Switzerland
211,13,Great Britain,0,0,2,2,1948,Winter,Switzerland
212,1,Norway,7,3,6,16,1952,Winter,Norway
213,2,United States,4,6,1,11,1952,Winter,Norway
214,3,Finland,3,4,2,9,1952,Winter,Norway
215,4,Germany,3,2,2,7,1952,Winter,Norway
216,5,Austria,2,4,2,8,1952,Winter,Norway
217,6,Canada,1,0,1,2,1952,Winter,Norway
218,6,Italy,1,0,1,2,1952,Winter,Norway
219,8,Great Britain,1,0,0,1,1952,Winter,Norway
220,9,Netherlands,0,3,0,3,1952,Winter,Norway
221,10,Sweden,0,0,4,4,1952,Winter,Norway
222,11,Switzerland,0,0,2,2,1952,Winter,Norway
223,12,France,0,0,1,1,1952,Winter,Norway
224,12,Hungary,0,0,1,1,1952,Winter,Norway
225,1,United States,40,19,17,76,1952,Summer,Finland
226,2,Soviet Union,22,30,19,71,1952,Summer,Finland
227,3,Hungary,16,10,16,42,1952,Summer,Finland
228,4,Sweden,12,13,10,35,1952,Summer,Finland
229,5,Italy,8,9,4,21,1952,Summer,Finland
230,6,Czechoslovakia,7,3,3,13,1952,Summer,Finland
231,7,France,6,6,6,18,1952,Summer,Finland
232,8,Finland,6,3,13,22,1952,Summer,Finland
233,9,Australia,6,2,3,11,1952,Summer,Finland
234,10,Norway,3,2,0,5,1952,Summer,Finland
235,11,Switzerland,2,6,6,14,1952,Summer,Finland
236,12,South Africa,2,4,4,10,1952,Summer,Finland
237,13,Jamaica,2,3,0,5,1952,Summer,Finland
238,14,Belgium,2,2,0,4,1952,Summer,Finland
239,15,Denmark,2,1,3,6,1952,Summer,Finland
240,16,Turkey,2,0,1,3,1952,Summer,Finland
241,17,Japan,1,6,2,9,1952,Summer,Finland
242,18,Great Britain,1,2,8,11,1952,Summer,Finland
243,19,Argentina,1,2,2,5,1952,Summer,Finland
244,20,Poland,1,2,1,4,1952,Summer,Finland
245,21,Canada,1,2,0,3,1952,Summer,Finland
246,21,Yugoslavia,1,2,0,3,1952,Summer,Finland
247,23,Romania,1,1,2,4,1952,Summer,Finland
248,24,Brazil,1,0,2,3,1952,Summer,Finland
249,24,New Zealand,1,0,2,3,1952,Summer,Finland
250,26,India,1,0,1,2,1952,Summer,Finland
251,27,Luxembourg,1,0,0,1,1952,Summer,Finland
252,28,Germany,0,7,17,24,1952,Summer,Finland
253,29,Netherlands,0,5,0,5,1952,Summer,Finland
254,30,Iran,0,3,4,7,1952,Summer,Finland
255,31,Chile,0,2,0,2,1952,Summer,Finland
256,32,Austria,0,1,1,2,1952,Summer,Finland
257,32,Lebanon,0,1,1,2,1952,Summer,Finland
258,34,Ireland,0,1,0,1,1952,Summer,Finland
259,34,Mexico,0,1,0,1,1952,Summer,Finland
260,34,Spain,0,1,0,1,1952,Summer,Finland
261,37,South Korea,0,0,2,2,1952,Summer,Finland
262,37,Trinidad And Tobago,0,0,2,2,1952,Summer,Finland
263,37,Uruguay,0,0,2,2,1952,Summer,Finland
264,40,Bulgaria,0,0,1,1,1952,Summer,Finland
265,40,Egypt,0,0,1,1,1952,Summer,Finland
266,40,Portugal,0,0,1,1,1952,Summer,Finland
267,40,Venezuela,0,0,1,1,1952,Summer,Finland
268,1,Soviet Union,7,3,6,16,1956,Winter,Italy
269,2,Austria,4,3,4,11,1956,Winter,Italy
270,3,Finland,3,3,1,7,1956,Winter,Italy
271,4,Switzerland,3,2,1,6,1956,Winter,Italy
272,5,Sweden,2,4,4,10,1956,Winter,Italy
273,6,United States,2,3,2,7,1956,Winter,Italy
274,7,Norway,2,1,1,4,1956,Winter,Italy
275,8,Italy,1,2,0,3,1956,Winter,Italy
276,9,United Team Of Germany,1,0,1,2,1956,Winter,Italy
277,10,Canada,0,1,2,3,1956,Winter,Italy
278,11,Japan,0,1,0,1,1956,Winter,Italy
279,12,Hungary,0,0,1,1,1956,Winter,Italy
280,12,Poland,0,0,1,1,1956,Winter,Italy
281,1,Soviet Union,37,29,32,98,1956,Summer,Australia
282,2,United States,32,25,17,74,1956,Summer,Australia
283,3,Australia,13,8,14,35,1956,Summer,Australia
284,4,Hungary,9,10,7,26,1956,Summer,Australia
285,5,Italy,8,8,9,25,1956,Summer,Australia
286,6,Sweden,8,5,6,19,1956,Summer,Australia
287,7,United Team Of Germany,6,13,7,26,1956,Summer,Australia
288,8,Great Britain,6,7,11,24,1956,Summer,Australia
289,9,Romania,5,3,5,13,1956,Summer,Australia
290,10,Japan,4,10,5,19,1956,Summer,Australia
291,11,France,4,4,6,14,1956,Summer,Australia
292,12,Turkey,3,2,2,7,1956,Summer,Australia
293,13,Finland,3,1,11,15,1956,Summer,Australia
294,14,Iran,2,2,1,5,1956,Summer,Australia
295,15,Canada,2,1,3,6,1956,Summer,Australia
296,16,New Zealand,2,0,0,2,1956,Summer,Australia
297,17,Poland,1,4,4,9,1956,Summer,Australia
298,18,Czechoslovakia,1,4,1,6,1956,Summer,Australia
299,19,Bulgaria,1,3,1,5,1956,Summer,Australia
300,20,Denmark,1,2,1,4,1956,Summer,Australia
301,21,Ireland,1,1,3,5,1956,Summer,Australia
302,22,Norway,1,0,2,3,1956,Summer,Australia
303,23,Mexico,1,0,1,2,1956,Summer,Australia
304,24,Brazil,1,0,0,1,1956,Summer,Australia
305,24,India,1,0,0,1,1956,Summer,Australia
306,26,Yugoslavia,0,3,0,3,1956,Summer,Australia
307,27,Chile,0,2,2,4,1956,Summer,Australia
308,28,Belgium,0,2,0,2,1956,Summer,Australia
309,29,Argentina,0,1,1,2,1956,Summer,Australia
310,29,South Korea,0,1,1,2,1956,Summer,Australia
311,31,Iceland,0,1,0,1,1956,Summer,Australia
312,31,Pakistan,0,1,0,1,1956,Summer,Australia
313,33,South Africa,0,0,4,4,1956,Summer,Australia
314,34,Austria,0,0,2,2,1956,Summer,Australia
315,35,Bahamas,0,0,1,1,1956,Summer,Australia
316,35,Greece,0,0,1,1,1956,Summer,Australia
317,35,Switzerland,0,0,1,1,1956,Summer,Australia
318,35,Uruguay,0,0,1,1,1956,Summer,Australia
319,1,Soviet Union,7,5,9,21,1960,Winter,USA
320,2,United Team Of Germany,4,3,1,8,1960,Winter,USA
321,3,United States,3,4,3,10,1960,Winter,USA
322,4,Norway,3,3,0,6,1960,Winter,USA
323,5,Sweden,3,2,2,7,1960,Winter,USA
324,6,Finland,2,3,3,8,1960,Winter,USA
325,7,Canada,2,1,1,4,1960,Winter,USA
326,8,Switzerland,2,0,0,2,1960,Winter,USA
327,9,Austria,1,2,3,6,1960,Winter,USA
328,10,France,1,0,2,3,1960,Winter,USA
329,11,Netherlands,0,1,1,2,1960,Winter,USA
330,11,Poland,0,1,1,2,1960,Winter,USA
331,13,Czechoslovakia,0,1,0,1,1960,Winter,USA
332,14,Italy,0,0,1,1,1960,Winter,USA
333,1,Soviet Union,43,29,31,103,1960,Summer,Italy
334,2,United States,34,21,16,71,1960,Summer,Italy
335,3,Italy,13,10,13,36,1960,Summer,Italy
336,4,United Team Of Germany,12,19,11,42,1960,Summer,Italy
337,5,Australia,8,8,6,22,1960,Summer,Italy
338,6,Turkey,7,2,0,9,1960,Summer,Italy
339,7,Hungary,6,8,7,21,1960,Summer,Italy
340,8,Japan,4,7,7,18,1960,Summer,Italy
341,9,Poland,4,6,11,21,1960,Summer,Italy
342,10,Czechoslovakia,3,2,3,8,1960,Summer,Italy
343,11,Romania,3,1,6,10,1960,Summer,Italy
344,12,Great Britain,2,6,12,20,1960,Summer,Italy
345,13,Denmark,2,3,1,6,1960,Summer,Italy
346,14,New Zealand,2,0,1,3,1960,Summer,Italy
347,15,Bulgaria,1,3,3,7,1960,Summer,Italy
348,16,Sweden,1,2,3,6,1960,Summer,Italy
349,17,Finland,1,1,3,5,1960,Summer,Italy
350,18,Austria,1,1,0,2,1960,Summer,Italy
351,18,Yugoslavia,1,1,0,2,1960,Summer,Italy
352,20,Pakistan,1,0,1,2,1960,Summer,Italy
353,21,Ethiopia,1,0,0,1,1960,Summer,Italy
354,21,Greece,1,0,0,1,1960,Summer,Italy
355,21,Norway,1,0,0,1,1960,Summer,Italy
356,24,Switzerland,0,3,3,6,1960,Summer,Italy
357,25,France,0,2,3,5,1960,Summer,Italy
358,26,Belgium,0,2,2,4,1960,Summer,Italy
359,27,Iran,0,1,3,4,1960,Summer,Italy
360,28,Netherlands,0,1,2,3,1960,Summer,Italy
361,28,South Africa,0,1,2,3,1960,Summer,Italy
362,30,Argentina,0,1,1,2,1960,Summer,Italy
363,30,Egypt,0,1,1,2,1960,Summer,Italy
364,32,Canada,0,1,0,1,1960,Summer,Italy
365,32,Formosa,0,1,0,1,1960,Summer,Italy
366,32,Ghana,0,1,0,1,1960,Summer,Italy
367,32,India,0,1,0,1,1960,Summer,Italy
368,32,Morocco,0,1,0,1,1960,Summer,Italy
369,32,Portugal,0,1,0,1,1960,Summer,Italy
370,32,Singapore,0,1,0,1,1960,Summer,Italy
371,39,Brazil,0,0,2,2,1960,Summer,Italy
372,39,British West Indies,0,0,2,2,1960,Summer,Italy
373,41,Iraq,0,0,1,1,1960,Summer,Italy
374,41,Mexico,0,0,1,1,1960,Summer,Italy
375,41,Spain,0,0,1,1,1960,Summer,Italy
376,41,Venezuela,0,0,1,1,1960,Summer,Italy
377,1,Soviet Union,11,8,6,25,1964,Winter,Austria
378,2,Austria,4,5,3,12,1964,Winter,Austria
379,3,Norway,3,6,6,15,1964,Winter,Austria
380,4,Finland,3,4,3,10,1964,Winter,Austria
381,5,France,3,4,0,7,1964,Winter,Austria
382,6,United Team Of Germany,3,3,3,9,1964,Winter,Austria
383,7,Sweden,3,3,1,7,1964,Winter,Austria
384,8,United States,1,2,4,7,1964,Winter,Austria
385,9,Canada,1,1,1,3,1964,Winter,Austria
386,10,Netherlands,1,1,0,2,1964,Winter,Austria
387,11,Great Britain,1,0,0,1,1964,Winter,Austria
388,12,Italy,0,1,3,4,1964,Winter,Austria
389,13,North Korea,0,1,0,1,1964,Winter,Austria
390,14,Czechoslovakia,0,0,1,1,1964,Winter,Austria
391,1,United States,36,26,28,90,1964,Summer,Japan
392,2,Soviet Union,30,31,35,96,1964,Summer,Japan
393,3,Japan,16,5,8,29,1964,Summer,Japan
394,4,United Team Of Germany,10,22,18,50,1964,Summer,Japan
395,5,Italy,10,10,7,27,1964,Summer,Japan
396,6,Hungary,10,7,5,22,1964,Summer,Japan
397,7,Poland,7,6,10,23,1964,Summer,Japan
398,8,Australia,6,2,10,18,1964,Summer,Japan
399,9,Czechoslovakia,5,6,3,14,1964,Summer,Japan
400,10,Great Britain,4,12,2,18,1964,Summer,Japan
401,11,Bulgaria,3,5,2,10,1964,Summer,Japan
402,12,Finland,3,0,2,5,1964,Summer,Japan
403,12,New Zealand,3,0,2,5,1964,Summer,Japan
404,14,Romania,2,4,6,12,1964,Summer,Japan
405,15,Netherlands,2,4,4,10,1964,Summer,Japan
406,16,Turkey,2,3,1,6,1964,Summer,Japan
407,17,Sweden,2,2,4,8,1964,Summer,Japan
408,18,Denmark,2,1,3,6,1964,Summer,Japan
409,19,Yugoslavia,2,1,2,5,1964,Summer,Japan
410,20,Belgium,2,0,1,3,1964,Summer,Japan
411,21,France,1,8,6,15,1964,Summer,Japan
412,22,Canada,1,2,1,4,1964,Summer,Japan
413,22,Switzerland,1,2,1,4,1964,Summer,Japan
414,24,Bahamas,1,0,0,1,1964,Summer,Japan
415,24,Ethiopia,1,0,0,1,1964,Summer,Japan
416,24,India,1,0,0,1,1964,Summer,Japan
417,27,South Korea,0,2,1,3,1964,Summer,Japan
418,28,Trinidad And Tobago,0,1,2,3,1964,Summer,Japan
419,29,Tunisia,0,1,1,2,1964,Summer,Japan
420,30,Argentina,0,1,0,1,1964,Summer,Japan
421,30,Cuba,0,1,0,1,1964,Summer,Japan
422,30,Pakistan,0,1,0,1,1964,Summer,Japan
423,30,Philippines,0,1,0,1,1964,Summer,Japan
424,34,Iran,0,0,2,2,1964,Summer,Japan
425,35,Brazil,0,0,1,1,1964,Summer,Japan
426,35,Ghana,0,0,1,1,1964,Summer,Japan
427,35,Ireland,0,0,1,1,1964,Summer,Japan
428,35,Kenya,0,0,1,1,1964,Summer,Japan
429,35,Mexico,0,0,1,1,1964,Summer,Japan
430,35,Nigeria,0,0,1,1,1964,Summer,Japan
431,35,Uruguay,0,0,1,1,1964,Summer,Japan
432,1,Norway,6,6,2,14,1968,Winter,France
433,2,Soviet Union,5,5,3,13,1968,Winter,France
434,3,France,4,3,2,9,1968,Winter,France
435,4,Italy,4,0,0,4,1968,Winter,France
436,5,Austria,3,4,4,11,1968,Winter,France
437,6,Netherlands,3,3,3,9,1968,Winter,France
438,7,Sweden,3,2,3,8,1968,Winter,France
439,8,West Germany,2,2,3,7,1968,Winter,France
440,9,United States,1,5,1,7,1968,Winter,France
441,10,East Germany,1,2,2,5,1968,Winter,France
442,10,Finland,1,2,2,5,1968,Winter,France
443,12,Czechoslovakia,1,2,1,4,1968,Winter,France
444,13,Canada,1,1,1,3,1968,Winter,France
445,14,Switzerland,0,2,4,6,1968,Winter,France
446,15,Romania,0,0,1,1,1968,Winter,France
447,1,United States,45,28,34,107,1968,Summer,Mexico
448,2,Soviet Union,29,32,30,91,1968,Summer,Mexico
449,3,Japan,11,7,7,25,1968,Summer,Mexico
450,4,Hungary,10,10,12,32,1968,Summer,Mexico
451,5,East Germany,9,9,7,25,1968,Summer,Mexico
452,6,France,7,3,5,15,1968,Summer,Mexico
453,7,Czechoslovakia,7,2,4,13,1968,Summer,Mexico
454,8,West Germany,5,11,10,26,1968,Summer,Mexico
455,9,Australia,5,7,5,17,1968,Summer,Mexico
456,10,Great Britain,5,5,3,13,1968,Summer,Mexico
457,11,Poland,5,2,11,18,1968,Summer,Mexico
458,12,Romania,4,6,5,15,1968,Summer,Mexico
459,13,Italy,3,4,9,16,1968,Summer,Mexico
460,14,Kenya,3,4,2,9,1968,Summer,Mexico
461,15,Mexico,3,3,3,9,1968,Summer,Mexico
462,16,Yugoslavia,3,3,2,8,1968,Summer,Mexico
463,17,Netherlands,3,3,1,7,1968,Summer,Mexico
464,18,Bulgaria,2,4,3,9,1968,Summer,Mexico
465,19,Iran,2,1,2,5,1968,Summer,Mexico
466,20,Sweden,2,1,1,4,1968,Summer,Mexico
467,21,Turkey,2,0,0,2,1968,Summer,Mexico
468,22,Denmark,1,4,3,8,1968,Summer,Mexico
469,23,Canada,1,3,1,5,1968,Summer,Mexico
470,24,Finland,1,2,1,4,1968,Summer,Mexico
471,25,Ethiopia,1,1,0,2,1968,Summer,Mexico
472,25,Norway,1,1,0,2,1968,Summer,Mexico
473,27,New Zealand,1,0,2,3,1968,Summer,Mexico
474,28,Tunisia,1,0,1,2,1968,Summer,Mexico
475,29,Pakistan,1,0,0,1,1968,Summer,Mexico
476,29,Venezuela,1,0,0,1,1968,Summer,Mexico
477,31,Cuba,0,4,0,4,1968,Summer,Mexico
478,32,Austria,0,2,2,4,1968,Summer,Mexico
479,33,Switzerland,0,1,4,5,1968,Summer,Mexico
480,34,Mongolia,0,1,3,4,1968,Summer,Mexico
481,35,Brazil,0,1,2,3,1968,Summer,Mexico
482,36,Belgium,0,1,1,2,1968,Summer,Mexico
483,36,South Korea,0,1,1,2,1968,Summer,Mexico
484,36,Uganda,0,1,1,2,1968,Summer,Mexico
485,39,Cameroon,0,1,0,1,1968,Summer,Mexico
486,39,Jamaica,0,1,0,1,1968,Summer,Mexico
487,41,Argentina,0,0,2,2,1968,Summer,Mexico
488,42,Greece,0,0,1,1,1968,Summer,Mexico
489,42,India,0,0,1,1,1968,Summer,Mexico
490,42,Taiwan,0,0,1,1,1968,Summer,Mexico
491,1,Soviet Union,8,5,3,16,1972,Winter,Japan
492,2,East Germany,4,3,7,14,1972,Winter,Japan
493,3,Switzerland,4,3,3,10,1972,Winter,Japan
494,4,Netherlands,4,3,2,9,1972,Winter,Japan
495,5,United States,3,2,3,8,1972,Winter,Japan
496,6,West Germany,3,1,1,5,1972,Winter,Japan
497,7,Norway,2,5,5,12,1972,Winter,Japan
498,8,Italy,2,2,1,5,1972,Winter,Japan
499,9,Austria,1,2,2,5,1972,Winter,Japan
500,10,Sweden,1,1,2,4,1972,Winter,Japan
501,11,Japan,1,1,1,3,1972,Winter,Japan
502,12,Czechoslovakia,1,0,2,3,1972,Winter,Japan
503,13,Poland,1,0,0,1,1972,Winter,Japan
504,13,Spain,1,0,0,1,1972,Winter,Japan
505,15,Finland,0,4,1,5,1972,Winter,Japan
506,16,France,0,1,2,3,1972,Winter,Japan
507,17,Canada,0,1,0,1,1972,Winter,Japan
508,1,Soviet Union,50,27,22,99,1972,Summer,Germany
509,2,United States,33,31,30,94,1972,Summer,Germany
510,3,East Germany,20,23,23,66,1972,Summer,Germany
511,4,West Germany,13,11,16,40,1972,Summer,Germany
512,5,Japan,13,8,8,29,1972,Summer,Germany
513,6,Australia,8,7,2,17,1972,Summer,Germany
514,7,Poland,7,5,9,21,1972,Summer,Germany
515,8,Hungary,6,13,16,35,1972,Summer,Germany
516,9,Bulgaria,6,10,5,21,1972,Summer,Germany
517,10,Italy,5,3,10,18,1972,Summer,Germany
518,11,Sweden,4,6,6,16,1972,Summer,Germany
519,12,Great Britain,4,5,9,18,1972,Summer,Germany
520,13,Romania,3,6,7,16,1972,Summer,Germany
521,14,Cuba,3,1,4,8,1972,Summer,Germany
522,14,Finland,3,1,4,8,1972,Summer,Germany
523,16,Netherlands,3,1,1,5,1972,Summer,Germany
524,17,France,2,4,7,13,1972,Summer,Germany
525,18,Czechoslovakia,2,4,2,8,1972,Summer,Germany
526,19,Kenya,2,3,4,9,1972,Summer,Germany
527,20,Yugoslavia,2,1,2,5,1972,Summer,Germany
528,21,Norway,2,1,1,4,1972,Summer,Germany
529,22,North Korea,1,1,3,5,1972,Summer,Germany
530,23,New Zealand,1,1,1,3,1972,Summer,Germany
531,24,Uganda,1,1,0,2,1972,Summer,Germany
532,25,Denmark,1,0,0,1,1972,Summer,Germany
533,26,Switzerland,0,3,0,3,1972,Summer,Germany
534,27,Canada,0,2,3,5,1972,Summer,Germany
535,28,Iran,0,2,1,3,1972,Summer,Germany
536,29,Belgium,0,2,0,2,1972,Summer,Germany
537,29,Greece,0,2,0,2,1972,Summer,Germany
538,31,Austria,0,1,2,3,1972,Summer,Germany
539,31,Colombia,0,1,2,3,1972,Summer,Germany
540,33,Argentina,0,1,0,1,1972,Summer,Germany
541,33,Lebanon,0,1,0,1,1972,Summer,Germany
542,33,Mexico,0,1,0,1,1972,Summer,Germany
543,33,Mongolia,0,1,0,1,1972,Summer,Germany
544,33,Pakistan,0,1,0,1,1972,Summer,Germany
545,33,South Korea,0,1,0,1,1972,Summer,Germany
546,33,Tunisia,0,1,0,1,1972,Summer,Germany
547,33,Turkey,0,1,0,1,1972,Summer,Germany
548,41,Brazil,0,0,2,2,1972,Summer,Germany
549,41,Ethiopia,0,0,2,2,1972,Summer,Germany
550,43,Ghana,0,0,1,1,1972,Summer,Germany
551,43,India,0,0,1,1,1972,Summer,Germany
552,43,Jamaica,0,0,1,1,1972,Summer,Germany
553,43,Niger,0,0,1,1,1972,Summer,Germany
554,43,Nigeria,0,0,1,1,1972,Summer,Germany
555,43,Spain,0,0,1,1,1972,Summer,Germany
556,1,Soviet Union,13,6,8,27,1976,Winter,Austria
557,2,East Germany,7,5,7,19,1976,Winter,Austria
558,3,United States,3,3,4,10,1976,Winter,Austria
559,4,Norway,3,3,1,7,1976,Winter,Austria
560,5,West Germany,2,5,3,10,1976,Winter,Austria
561,6,Finland,2,4,1,7,1976,Winter,Austria
562,7,Austria,2,2,2,6,1976,Winter,Austria
563,8,Switzerland,1,3,1,5,1976,Winter,Austria
564,9,Netherlands,1,2,3,6,1976,Winter,Austria
565,10,Italy,1,2,1,4,1976,Winter,Austria
566,11,Canada,1,1,1,3,1976,Winter,Austria
567,12,Great Britain,1,0,0,1,1976,Winter,Austria
568,13,Czechoslovakia,0,1,0,1,1976,Winter,Austria
569,14,Liechtenstein,0,0,2,2,1976,Winter,Austria
570,14,Sweden,0,0,2,2,1976,Winter,Austria
571,16,France,0,0,1,1,1976,Winter,Austria
572,1,Soviet Union,49,41,35,125,1976,Summer,Canada
573,2,East Germany,40,25,25,90,1976,Summer,Canada
574,3,United States,34,35,25,94,1976,Summer,Canada
575,4,West Germany,10,12,17,39,1976,Summer,Canada
576,5,Japan,9,6,10,25,1976,Summer,Canada
577,6,Poland,7,6,13,26,1976,Summer,Canada
578,7,Bulgaria,6,9,7,22,1976,Summer,Canada
579,8,Cuba,6,4,3,13,1976,Summer,Canada
580,9,Romania,4,9,14,27,1976,Summer,Canada
581,10,Hungary,4,5,13,22,1976,Summer,Canada
582,11,Finland,4,2,0,6,1976,Summer,Canada
583,12,Sweden,4,1,0,5,1976,Summer,Canada
584,13,Great Britain,3,5,5,13,1976,Summer,Canada
585,14,Italy,2,7,4,13,1976,Summer,Canada
586,15,France,2,3,4,9,1976,Summer,Canada
587,16,Yugoslavia,2,3,3,8,1976,Summer,Canada
588,17,Czechoslovakia,2,2,4,8,1976,Summer,Canada
589,18,New Zealand,2,1,1,4,1976,Summer,Canada
590,19,South Korea,1,1,4,6,1976,Summer,Canada
591,20,Switzerland,1,1,2,4,1976,Summer,Canada
592,21,Jamaica,1,1,0,2,1976,Summer,Canada
593,21,North Korea,1,1,0,2,1976,Summer,Canada
594,21,Norway,1,1,0,2,1976,Summer,Canada
595,24,Denmark,1,0,2,3,1976,Summer,Canada
596,25,Mexico,1,0,1,2,1976,Summer,Canada
597,26,Trinidad And Tobago,1,0,0,1,1976,Summer,Canada
598,27,Canada,0,5,6,11,1976,Summer,Canada
599,28,Belgium,0,3,3,6,1976,Summer,Canada
600,29,Netherlands,0,2,3,5,1976,Summer,Canada
601,30,Portugal,0,2,0,2,1976,Summer,Canada
602,30,Spain,0,2,0,2,1976,Summer,Canada
603,32,Australia,0,1,4,5,1976,Summer,Canada
604,33,Iran,0,1,1,2,1976,Summer,Canada
605,34,Mongolia,0,1,0,1,1976,Summer,Canada
606,34,Venezuela,0,1,0,1,1976,Summer,Canada
607,36,Brazil,0,0,2,2,1976,Summer,Canada
608,37,Austria,0,0,1,1,1976,Summer,Canada
609,37,Bermuda,0,0,1,1,1976,Summer,Canada
610,37,Pakistan,0,0,1,1,1976,Summer,Canada
611,37,Puerto Rico,0,0,1,1,1976,Summer,Canada
612,37,Thailand,0,0,1,1,1976,Summer,Canada
613,1,Soviet Union,10,6,6,22,1980,Winter,USA
614,2,East Germany,9,7,7,23,1980,Winter,USA
615,3,United States,6,4,2,12,1980,Winter,USA
616,4,Austria,3,2,2,7,1980,Winter,USA
617,5,Sweden,3,0,1,4,1980,Winter,USA
618,6,Liechtenstein,2,2,0,4,1980,Winter,USA
619,7,Finland,1,5,3,9,1980,Winter,USA
620,8,Norway,1,3,6,10,1980,Winter,USA
621,9,Netherlands,1,2,1,4,1980,Winter,USA
622,10,Switzerland,1,1,3,5,1980,Winter,USA
623,11,Great Britain,1,0,0,1,1980,Winter,USA
624,12,West Germany,0,2,3,5,1980,Winter,USA
625,13,Italy,0,2,0,2,1980,Winter,USA
626,14,Canada,0,1,1,2,1980,Winter,USA
627,15,Hungary,0,1,0,1,1980,Winter,USA
628,15,Japan,0,1,0,1,1980,Winter,USA
629,17,Bulgaria,0,0,1,1,1980,Winter,USA
630,17,Czechoslovakia,0,0,1,1,1980,Winter,USA
631,17,France,0,0,1,1,1980,Winter,USA
632,1,Soviet Union,80,69,46,195,1980,Summer,USSR
633,2,East Germany,47,37,42,126,1980,Summer,USSR
634,3,Bulgaria,8,16,17,41,1980,Summer,USSR
635,4,Cuba,8,7,5,20,1980,Summer,USSR
636,5,Italy,8,3,4,15,1980,Summer,USSR
637,6,Hungary,7,10,15,32,1980,Summer,USSR
638,7,Romania,6,6,13,25,1980,Summer,USSR
639,8,France,6,5,3,14,1980,Summer,USSR
640,9,Great Britain,5,7,9,21,1980,Summer,USSR
641,10,Poland,3,14,15,32,1980,Summer,USSR
642,11,Sweden,3,3,6,12,1980,Summer,USSR
643,12,Finland,3,1,4,8,1980,Summer,USSR
644,13,Czechoslovakia,2,3,9,14,1980,Summer,USSR
645,14,Yugoslavia,2,3,4,9,1980,Summer,USSR
646,15,Australia,2,2,5,9,1980,Summer,USSR
647,16,Denmark,2,1,2,5,1980,Summer,USSR
648,17,Brazil,2,0,2,4,1980,Summer,USSR
649,17,Ethiopia,2,0,2,4,1980,Summer,USSR
650,19,Switzerland,2,0,0,2,1980,Summer,USSR
651,20,Spain,1,3,2,6,1980,Summer,USSR
652,21,Austria,1,2,1,4,1980,Summer,USSR
653,22,Greece,1,0,2,3,1980,Summer,USSR
654,23,Belgium,1,0,0,1,1980,Summer,USSR
655,23,India,1,0,0,1,1980,Summer,USSR
656,23,Zimbabwe,1,0,0,1,1980,Summer,USSR
657,26,North Korea,0,3,2,5,1980,Summer,USSR
658,27,Mongolia,0,2,2,4,1980,Summer,USSR
659,28,Tanzania,0,2,0,2,1980,Summer,USSR
660,29,Mexico,0,1,3,4,1980,Summer,USSR
661,30,Netherlands,0,1,2,3,1980,Summer,USSR
662,31,Ireland,0,1,1,2,1980,Summer,USSR
663,32,Uganda,0,1,0,1,1980,Summer,USSR
664,32,Venezuela,0,1,0,1,1980,Summer,USSR
665,34,Jamaica,0,0,3,3,1980,Summer,USSR
666,35,Guyana,0,0,1,1,1980,Summer,USSR
667,35,Lebanon,0,0,1,1,1980,Summer,USSR
668,1,East Germany,9,9,6,24,1984,Winter,Yugoslavia
669,2,Soviet Union,6,10,9,25,1984,Winter,Yugoslavia
670,3,United States,4,4,0,8,1984,Winter,Yugoslavia
671,4,Finland,4,3,6,13,1984,Winter,Yugoslavia
672,5,Sweden,4,2,2,8,1984,Winter,Yugoslavia
673,6,Norway,3,2,4,9,1984,Winter,Yugoslavia
674,7,Switzerland,2,2,1,5,1984,Winter,Yugoslavia
675,8,Canada,2,1,1,4,1984,Winter,Yugoslavia
676,8,West Germany,2,1,1,4,1984,Winter,Yugoslavia
677,10,Italy,2,0,0,2,1984,Winter,Yugoslavia
678,11,Great Britain,1,0,0,1,1984,Winter,Yugoslavia
679,12,Czechoslovakia,0,2,4,6,1984,Winter,Yugoslavia
680,13,France,0,1,2,3,1984,Winter,Yugoslavia
681,14,Japan,0,1,0,1,1984,Winter,Yugoslavia
682,14,Yugoslavia,0,1,0,1,1984,Winter,Yugoslavia
683,16,Liechtenstein,0,0,2,2,1984,Winter,Yugoslavia
684,17,Austria,0,0,1,1,1984,Winter,Yugoslavia
685,1,United States,83,61,30,174,1984,Summer,USA
686,2,Romania,20,16,17,53,1984,Summer,USA
687,3,West Germany,17,19,23,59,1984,Summer,USA
688,4,China,15,8,9,32,1984,Summer,USA
689,5,Italy,14,6,12,32,1984,Summer,USA
690,6,Canada,10,18,16,44,1984,Summer,USA
691,7,Japan,10,8,14,32,1984,Summer,USA
692,8,New Zealand,8,1,2,11,1984,Summer,USA
693,9,Yugoslavia,7,4,7,18,1984,Summer,USA
694,10,South Korea,6,6,7,19,1984,Summer,USA
695,11,Great Britain,5,11,21,37,1984,Summer,USA
696,12,France,5,7,16,28,1984,Summer,USA
697,13,Netherlands,5,2,6,13,1984,Summer,USA
698,14,Australia,4,8,12,24,1984,Summer,USA
699,15,Finland,4,2,6,12,1984,Summer,USA
700,16,Sweden,2,11,6,19,1984,Summer,USA
701,17,Mexico,2,3,1,6,1984,Summer,USA
702,18,Morocco,2,0,0,2,1984,Summer,USA
703,19,Brazil,1,5,2,8,1984,Summer,USA
704,20,Spain,1,2,2,5,1984,Summer,USA
705,21,Belgium,1,1,2,4,1984,Summer,USA
706,22,Austria,1,1,1,3,1984,Summer,USA
707,23,Kenya,1,0,2,3,1984,Summer,USA
708,23,Portugal,1,0,2,3,1984,Summer,USA
709,25,Pakistan,1,0,0,1,1984,Summer,USA
710,26,Switzerland,0,4,4,8,1984,Summer,USA
711,27,Denmark,0,3,3,6,1984,Summer,USA
712,28,Jamaica,0,1,2,3,1984,Summer,USA
713,28,Norway,0,1,2,3,1984,Summer,USA
714,30,Greece,0,1,1,2,1984,Summer,USA
715,30,Nigeria,0,1,1,2,1984,Summer,USA
716,30,Puerto Rico,0,1,1,2,1984,Summer,USA
717,33,Colombia,0,1,0,1,1984,Summer,USA
718,33,Egypt,0,1,0,1,1984,Summer,USA
719,33,Ireland,0,1,0,1,1984,Summer,USA
720,33,Ivory Coast,0,1,0,1,1984,Summer,USA
721,33,Peru,0,1,0,1,1984,Summer,USA
722,33,Syria,0,1,0,1,1984,Summer,USA
723,33,Thailand,0,1,0,1,1984,Summer,USA
724,40,Turkey,0,0,3,3,1984,Summer,USA
725,40,Venezuela,0,0,3,3,1984,Summer,USA
726,42,Algeria,0,0,2,2,1984,Summer,USA
727,43,Cameroon,0,0,1,1,1984,Summer,USA
728,43,Chinese Taipei,0,0,1,1,1984,Summer,USA
729,43,Dominican Republic,0,0,1,1,1984,Summer,USA
730,43,Iceland,0,0,1,1,1984,Summer,USA
731,43,Zambia,0,0,1,1,1984,Summer,USA
732,1,Soviet Union,11,9,9,29,1988,Winter,Canada
733,2,East Germany,9,10,6,25,1988,Winter,Canada
734,3,Switzerland,5,5,5,15,1988,Winter,Canada
735,4,Finland,4,1,2,7,1988,Winter,Canada
736,5,Sweden,4,0,2,6,1988,Winter,Canada
737,6,Austria,3,5,2,10,1988,Winter,Canada
738,7,Netherlands,3,2,2,7,1988,Winter,Canada
739,8,West Germany,2,4,2,8,1988,Winter,Canada
740,9,United States,2,1,3,6,1988,Winter,Canada
741,10,Italy,2,1,2,5,1988,Winter,Canada
742,11,France,1,0,1,2,1988,Winter,Canada
743,12,Norway,0,3,2,5,1988,Winter,Canada
744,13,Canada,0,2,3,5,1988,Winter,Canada
745,14,Yugoslavia,0,2,1,3,1988,Winter,Canada
746,15,Czechoslovakia,0,1,2,3,1988,Winter,Canada
747,16,Japan,0,0,1,1,1988,Winter,Canada
748,16,Liechtenstein,0,0,1,1,1988,Winter,Canada
749,1,Soviet Union,55,31,46,132,1988,Summer,South Korea
750,2,East Germany,37,35,30,102,1988,Summer,South Korea
751,3,United States,36,31,27,94,1988,Summer,South Korea
752,4,South Korea,12,10,11,33,1988,Summer,South Korea
753,5,West Germany,11,14,15,40,1988,Summer,South Korea
754,6,Hungary,11,6,6,23,1988,Summer,South Korea
755,7,Bulgaria,10,12,13,35,1988,Summer,South Korea
756,8,Romania,7,11,6,24,1988,Summer,South Korea
757,9,France,6,4,6,16,1988,Summer,South Korea
758,10,Italy,6,4,4,14,1988,Summer,South Korea
759,11,China,5,11,12,28,1988,Summer,South Korea
760,12,Great Britain,5,10,9,24,1988,Summer,South Korea
761,13,Kenya,5,2,2,9,1988,Summer,South Korea
762,14,Japan,4,3,7,14,1988,Summer,South Korea
763,15,Australia,3,6,5,14,1988,Summer,South Korea
764,16,Yugoslavia,3,4,5,12,1988,Summer,South Korea
765,17,Czechoslovakia,3,3,2,8,1988,Summer,South Korea
766,18,New Zealand,3,2,8,13,1988,Summer,South Korea
767,19,Canada,3,2,5,10,1988,Summer,South Korea
768,20,Poland,2,5,9,16,1988,Summer,South Korea
769,21,Norway,2,3,0,5,1988,Summer,South Korea
770,22,Netherlands,2,2,5,9,1988,Summer,South Korea
771,23,Denmark,2,1,1,4,1988,Summer,South Korea
772,24,Brazil,1,2,3,6,1988,Summer,South Korea
773,25,Finland,1,1,2,4,1988,Summer,South Korea
774,25,Spain,1,1,2,4,1988,Summer,South Korea
775,27,Turkey,1,1,0,2,1988,Summer,South Korea
776,28,Morocco,1,0,2,3,1988,Summer,South Korea
777,29,Austria,1,0,0,1,1988,Summer,South Korea
778,29,Portugal,1,0,0,1,1988,Summer,South Korea
779,29,Suriname,1,0,0,1,1988,Summer,South Korea
780,32,Sweden,0,4,7,11,1988,Summer,South Korea
781,33,Switzerland,0,2,2,4,1988,Summer,South Korea
782,34,Jamaica,0,2,0,2,1988,Summer,South Korea
783,35,Argentina,0,1,1,2,1988,Summer,South Korea
784,36,Chile,0,1,0,1,1988,Summer,South Korea
785,36,Costa Rica,0,1,0,1,1988,Summer,South Korea
786,36,Indonesia,0,1,0,1,1988,Summer,South Korea
787,36,Iran,0,1,0,1,1988,Summer,South Korea
788,36,Netherlands Antilles,0,1,0,1,1988,Summer,South Korea
789,36,Peru,0,1,0,1,1988,Summer,South Korea
790,36,Senegal,0,1,0,1,1988,Summer,South Korea
791,36,Virgin Islands,0,1,0,1,1988,Summer,South Korea
792,44,Belgium,0,0,2,2,1988,Summer,South Korea
793,44,Mexico,0,0,2,2,1988,Summer,South Korea
794,46,Colombia,0,0,1,1,1988,Summer,South Korea
795,46,Djibouti,0,0,1,1,1988,Summer,South Korea
796,46,Greece,0,0,1,1,1988,Summer,South Korea
797,46,Mongolia,0,0,1,1,1988,Summer,South Korea
798,46,Pakistan,0,0,1,1,1988,Summer,South Korea
799,46,Philippines,0,0,1,1,1988,Summer,South Korea
800,46,Thailand,0,0,1,1,1988,Summer,South Korea
801,1,Germany,10,10,6,26,1992,Winter,France
802,2,Unified Team,9,6,8,23,1992,Winter,France
803,3,Norway,9,6,5,20,1992,Winter,France
804,4,Austria,6,7,8,21,1992,Winter,France
805,5,United States,5,4,2,11,1992,Winter,France
806,6,Italy,4,6,4,14,1992,Winter,France
807,7,France,3,5,1,9,1992,Winter,France
808,8,Finland,3,1,3,7,1992,Winter,France
809,9,Canada,2,3,2,7,1992,Winter,France
810,10,South Korea,2,1,1,4,1992,Winter,France
811,11,Japan,1,2,4,7,1992,Winter,France
812,12,Netherlands,1,1,2,4,1992,Winter,France
813,13,Sweden,1,0,3,4,1992,Winter,France
814,14,Switzerland,1,0,2,3,1992,Winter,France
815,15,China,0,3,0,3,1992,Winter,France
816,16,Luxembourg,0,2,0,2,1992,Winter,France
817,17,New Zealand,0,1,0,1,1992,Winter,France
818,18,Czechoslovakia,0,0,3,3,1992,Winter,France
819,19,North Korea,0,0,1,1,1992,Winter,France
820,19,Spain,0,0,1,1,1992,Winter,France
821,1,Unified Team,45,38,29,112,1992,Summer,Spain
822,2,United States,37,34,37,108,1992,Summer,Spain
823,3,Germany,33,21,28,82,1992,Summer,Spain
824,4,China,16,22,16,54,1992,Summer,Spain
825,5,Cuba,14,6,11,31,1992,Summer,Spain
826,6,Spain,13,7,2,22,1992,Summer,Spain
827,7,South Korea,12,5,12,29,1992,Summer,Spain
828,8,Hungary,11,12,7,30,1992,Summer,Spain
829,9,France,8,5,16,29,1992,Summer,Spain
830,10,Australia,7,9,11,27,1992,Summer,Spain
831,11,Canada,7,4,7,18,1992,Summer,Spain
832,12,Italy,6,5,8,19,1992,Summer,Spain
833,13,Great Britain,5,3,12,20,1992,Summer,Spain
834,14,Romania,4,6,8,18,1992,Summer,Spain
835,15,Czechoslovakia,4,2,1,7,1992,Summer,Spain
836,16,North Korea,4,0,5,9,1992,Summer,Spain
837,17,Japan,3,8,11,22,1992,Summer,Spain
838,18,Bulgaria,3,7,6,16,1992,Summer,Spain
839,19,Poland,3,6,10,19,1992,Summer,Spain
840,20,Netherlands,2,6,7,15,1992,Summer,Spain
841,21,Kenya,2,4,2,8,1992,Summer,Spain
842,22,Norway,2,4,1,7,1992,Summer,Spain
843,23,Turkey,2,2,2,6,1992,Summer,Spain
844,24,Indonesia,2,2,1,5,1992,Summer,Spain
845,25,Brazil,2,1,0,3,1992,Summer,Spain
846,26,Greece,2,0,0,2,1992,Summer,Spain
847,27,Sweden,1,7,4,12,1992,Summer,Spain
848,28,New Zealand,1,4,5,10,1992,Summer,Spain
849,29,Finland,1,2,2,5,1992,Summer,Spain
850,30,Denmark,1,1,4,6,1992,Summer,Spain
851,31,Morocco,1,1,1,3,1992,Summer,Spain
852,32,Ireland,1,1,0,2,1992,Summer,Spain
853,33,Ethiopia,1,0,2,3,1992,Summer,Spain
854,34,Algeria,1,0,1,2,1992,Summer,Spain
855,34,Estonia,1,0,1,2,1992,Summer,Spain
856,34,Lithuania,1,0,1,2,1992,Summer,Spain
857,37,Switzerland,1,0,0,1,1992,Summer,Spain
858,38,Jamaica,0,3,1,4,1992,Summer,Spain
859,38,Nigeria,0,3,1,4,1992,Summer,Spain
860,40,Latvia,0,2,1,3,1992,Summer,Spain
861,41,Austria,0,2,0,2,1992,Summer,Spain
862,41,Namibia,0,2,0,2,1992,Summer,Spain
863,41,South Africa,0,2,0,2,1992,Summer,Spain
864,44,Belgium,0,1,2,3,1992,Summer,Spain
865,44,Croatia,0,1,2,3,1992,Summer,Spain
866,44,Independent Olympic Participants,0,1,2,3,1992,Summer,Spain
867,44,Iran,0,1,2,3,1992,Summer,Spain
868,48,Israel,0,1,1,2,1992,Summer,Spain
869,49,Chinese Taipei,0,1,0,1,1992,Summer,Spain
870,49,Mexico,0,1,0,1,1992,Summer,Spain
871,49,Peru,0,1,0,1,1992,Summer,Spain
872,52,Mongolia,0,0,2,2,1992,Summer,Spain
873,52,Slovenia,0,0,2,2,1992,Summer,Spain
874,54,Argentina,0,0,1,1,1992,Summer,Spain
875,54,Bahamas,0,0,1,1,1992,Summer,Spain
876,54,Colombia,0,0,1,1,1992,Summer,Spain
877,54,Ghana,0,0,1,1,1992,Summer,Spain
878,54,Malaysia,0,0,1,1,1992,Summer,Spain
879,54,Pakistan,0,0,1,1,1992,Summer,Spain
880,54,Philippines,0,0,1,1,1992,Summer,Spain
881,54,Puerto Rico,0,0,1,1,1992,Summer,Spain
882,54,Qatar,0,0,1,1,1992,Summer,Spain
883,54,Suriname,0,0,1,1,1992,Summer,Spain
884,54,Thailand,0,0,1,1,1992,Summer,Spain
885,1,Russia,11,8,4,23,1994,Winter,Norway
886,2,Norway,10,11,5,26,1994,Winter,Norway
887,3,Germany,9,7,8,24,1994,Winter,Norway
888,4,Italy,7,5,8,20,1994,Winter,Norway
889,5,United States,6,5,2,13,1994,Winter,Norway
890,6,South Korea,4,1,1,6,1994,Winter,Norway
891,7,Canada,3,6,4,13,1994,Winter,Norway
892,8,Switzerland,3,4,2,9,1994,Winter,Norway
893,9,Austria,2,3,4,9,1994,Winter,Norway
894,10,Sweden,2,1,0,3,1994,Winter,Norway
895,11,Japan,1,2,2,5,1994,Winter,Norway
896,12,Kazakhstan,1,2,0,3,1994,Winter,Norway
897,13,Ukraine,1,0,1,2,1994,Winter,Norway
898,14,Uzbekistan,1,0,0,1,1994,Winter,Norway
899,15,Belarus,0,2,0,2,1994,Winter,Norway
900,16,Finland,0,1,5,6,1994,Winter,Norway
901,17,France,0,1,4,5,1994,Winter,Norway
902,18,Netherlands,0,1,3,4,1994,Winter,Norway
903,19,China,0,1,2,3,1994,Winter,Norway
904,20,Slovenia,0,0,3,3,1994,Winter,Norway
905,21,Great Britain,0,0,2,2,1994,Winter,Norway
906,22,Australia,0,0,1,1,1994,Winter,Norway
907,1,United States,44,32,25,101,1996,Summer,USA
908,2,Russia,26,21,16,63,1996,Summer,USA
909,3,Germany,20,18,27,65,1996,Summer,USA
910,4,China,16,22,12,50,1996,Summer,USA
911,5,France,15,7,15,37,1996,Summer,USA
912,6,Italy,13,10,12,35,1996,Summer,USA
913,7,Australia,9,9,23,41,1996,Summer,USA
914,8,Cuba,9,8,8,25,1996,Summer,USA
915,9,Ukraine,9,2,12,23,1996,Summer,USA
916,10,South Korea,7,15,5,27,1996,Summer,USA
917,11,Poland,7,5,5,17,1996,Summer,USA
918,12,Hungary,7,4,10,21,1996,Summer,USA
919,13,Spain,5,6,6,17,1996,Summer,USA
920,14,Romania,4,7,9,20,1996,Summer,USA
921,15,Netherlands,4,5,10,19,1996,Summer,USA
922,16,Greece,4,4,0,8,1996,Summer,USA
923,17,Czech Republic,4,3,4,11,1996,Summer,USA
924,18,Switzerland,4,3,0,7,1996,Summer,USA
925,19,Denmark,4,1,1,6,1996,Summer,USA
926,19,Turkey,4,1,1,6,1996,Summer,USA
927,21,Canada,3,11,8,22,1996,Summer,USA
928,22,Bulgaria,3,7,5,15,1996,Summer,USA
929,23,Japan,3,6,5,14,1996,Summer,USA
930,24,Kazakhstan,3,4,4,11,1996,Summer,USA
931,25,Brazil,3,3,9,15,1996,Summer,USA
932,26,New Zealand,3,2,1,6,1996,Summer,USA
933,27,South Africa,3,1,1,5,1996,Summer,USA
934,28,Ireland,3,0,1,4,1996,Summer,USA
935,29,Sweden,2,4,2,8,1996,Summer,USA
936,30,Norway,2,2,3,7,1996,Summer,USA
937,31,Belgium,2,2,2,6,1996,Summer,USA
938,32,Nigeria,2,1,3,6,1996,Summer,USA
939,33,North Korea,2,1,2,5,1996,Summer,USA
940,34,Algeria,2,0,1,3,1996,Summer,USA
941,34,Ethiopia,2,0,1,3,1996,Summer,USA
942,36,Great Britain,1,8,6,15,1996,Summer,USA
943,37,Belarus,1,6,8,15,1996,Summer,USA
944,38,Kenya,1,4,3,8,1996,Summer,USA
945,39,Jamaica,1,3,2,6,1996,Summer,USA
946,40,Finland,1,2,1,4,1996,Summer,USA
947,41,Fr Yugoslavia,1,1,2,4,1996,Summer,USA
948,41,Indonesia,1,1,2,4,1996,Summer,USA
949,43,Iran,1,1,1,3,1996,Summer,USA
950,43,Slovakia,1,1,1,3,1996,Summer,USA
951,45,Armenia,1,1,0,2,1996,Summer,USA
952,45,Croatia,1,1,0,2,1996,Summer,USA
953,47,Portugal,1,0,1,2,1996,Summer,USA
954,47,Thailand,1,0,1,2,1996,Summer,USA
955,49,Burundi,1,0,0,1,1996,Summer,USA
956,49,Costa Rica,1,0,0,1,1996,Summer,USA
957,49,Ecuador,1,0,0,1,1996,Summer,USA
958,49,Hong Kong,1,0,0,1,1996,Summer,USA
959,49,Syria,1,0,0,1,1996,Summer,USA
960,54,Argentina,0,2,1,3,1996,Summer,USA
961,55,Namibia,0,2,0,2,1996,Summer,USA
962,55,Slovenia,0,2,0,2,1996,Summer,USA
963,57,Austria,0,1,2,3,1996,Summer,USA
964,58,Malaysia,0,1,1,2,1996,Summer,USA
965,58,Moldova,0,1,1,2,1996,Summer,USA
966,58,Uzbekistan,0,1,1,2,1996,Summer,USA
967,61,Azerbaijan,0,1,0,1,1996,Summer,USA
968,61,Bahamas,0,1,0,1,1996,Summer,USA
969,61,Chinese Taipei,0,1,0,1,1996,Summer,USA
970,61,Latvia,0,1,0,1,1996,Summer,USA
971,61,Philippines,0,1,0,1,1996,Summer,USA
972,61,Tonga,0,1,0,1,1996,Summer,USA
973,61,Zambia,0,1,0,1,1996,Summer,USA
974,68,Georgia,0,0,2,2,1996,Summer,USA
975,68,Morocco,0,0,2,2,1996,Summer,USA
976,68,Trinidad And Tobago,0,0,2,2,1996,Summer,USA
977,71,India,0,0,1,1,1996,Summer,USA
978,71,Israel,0,0,1,1,1996,Summer,USA
979,71,Lithuania,0,0,1,1,1996,Summer,USA
980,71,Mexico,0,0,1,1,1996,Summer,USA
981,71,Mongolia,0,0,1,1,1996,Summer,USA
982,71,Mozambique,0,0,1,1,1996,Summer,USA
983,71,Puerto Rico,0,0,1,1,1996,Summer,USA
984,71,Tunisia,0,0,1,1,1996,Summer,USA
985,71,Uganda,0,0,1,1,1996,Summer,USA
986,1,Germany,12,9,8,29,1998,Winter,Japan
987,2,Norway,10,10,5,25,1998,Winter,Japan
988,3,Russia,9,6,3,18,1998,Winter,Japan
989,4,Canada,6,5,4,15,1998,Winter,Japan
990,5,United States,6,3,4,13,1998,Winter,Japan
991,6,Netherlands,5,4,2,11,1998,Winter,Japan
992,7,Japan,5,1,4,10,1998,Winter,Japan
993,8,Austria,3,5,9,17,1998,Winter,Japan
994,9,South Korea,3,1,2,6,1998,Winter,Japan
995,10,Italy,2,6,2,10,1998,Winter,Japan
996,11,Finland,2,4,6,12,1998,Winter,Japan
997,12,Switzerland,2,2,3,7,1998,Winter,Japan
998,13,France,2,1,5,8,1998,Winter,Japan
999,14,Czech Republic,1,1,1,3,1998,Winter,Japan
1000,15,Bulgaria,1,0,0,1,1998,Winter,Japan
1001,16,China,0,6,2,8,1998,Winter,Japan
1002,17,Sweden,0,2,1,3,1998,Winter,Japan
1003,18,Denmark,0,1,0,1,1998,Winter,Japan
1004,18,Ukraine,0,1,0,1,1998,Winter,Japan
1005,20,Belarus,0,0,2,2,1998,Winter,Japan
1006,20,Kazakhstan,0,0,2,2,1998,Winter,Japan
1007,22,Australia,0,0,1,1,1998,Winter,Japan
1008,22,Belgium,0,0,1,1,1998,Winter,Japan
1009,22,Great Britain,0,0,1,1,1998,Winter,Japan
1010,1,United States,37,24,32,93,2000,Summer,Australia
1011,2,Russia,32,28,29,89,2000,Summer,Australia
1012,3,China,28,16,14,58,2000,Summer,Australia
1013,4,Australia,16,25,17,58,2000,Summer,Australia
1014,5,Germany,13,17,26,56,2000,Summer,Australia
1015,6,France,13,14,11,38,2000,Summer,Australia
1016,7,Italy,13,8,13,34,2000,Summer,Australia
1017,8,Netherlands,12,9,4,25,2000,Summer,Australia
1018,9,Cuba,11,11,7,29,2000,Summer,Australia
1019,10,Great Britain,11,10,7,28,2000,Summer,Australia
1020,11,Romania,11,6,9,26,2000,Summer,Australia
1021,12,South Korea,8,10,10,28,2000,Summer,Australia
1022,13,Hungary,8,6,3,17,2000,Summer,Australia
1023,14,Poland,6,5,3,14,2000,Summer,Australia
1024,15,Japan,5,8,5,18,2000,Summer,Australia
1025,16,Bulgaria,5,6,2,13,2000,Summer,Australia
1026,17,Greece,4,6,3,13,2000,Summer,Australia
1027,18,Sweden,4,5,3,12,2000,Summer,Australia
1028,19,Norway,4,3,3,10,2000,Summer,Australia
1029,20,Ethiopia,4,1,3,8,2000,Summer,Australia
1030,21,Ukraine,3,10,10,23,2000,Summer,Australia
1031,22,Kazakhstan,3,4,0,7,2000,Summer,Australia
1032,23,Belarus,3,3,11,17,2000,Summer,Australia
1033,24,Canada,3,3,8,14,2000,Summer,Australia
1034,25,Spain,3,3,5,11,2000,Summer,Australia
1035,26,Turkey,3,0,2,5,2000,Summer,Australia
1036,27,Iran,3,0,1,4,2000,Summer,Australia
1037,28,Czech Republic,2,3,3,8,2000,Summer,Australia
1038,29,Kenya,2,3,2,7,2000,Summer,Australia
1039,30,Denmark,2,3,1,6,2000,Summer,Australia
1040,31,Finland,2,1,1,4,2000,Summer,Australia
1041,32,Austria,2,1,0,3,2000,Summer,Australia
1042,33,Lithuania,2,0,3,5,2000,Summer,Australia
1043,34,Azerbaijan,2,0,1,3,2000,Summer,Australia
1044,34,Bahamas,2,0,1,3,2000,Summer,Australia
1045,36,Slovenia,2,0,0,2,2000,Summer,Australia
1046,37,Switzerland,1,6,2,9,2000,Summer,Australia
1047,38,Indonesia,1,3,2,6,2000,Summer,Australia
1048,39,Slovakia,1,3,1,5,2000,Summer,Australia
1049,40,Mexico,1,2,3,6,2000,Summer,Australia
1050,41,Nigeria,1,2,0,3,2000,Summer,Australia
1051,42,Algeria,1,1,3,5,2000,Summer,Australia
1052,43,Uzbekistan,1,1,2,4,2000,Summer,Australia
1053,44,Fr Yugoslavia,1,1,1,3,2000,Summer,Australia
1054,44,Latvia,1,1,1,3,2000,Summer,Australia
1055,46,New Zealand,1,0,3,4,2000,Summer,Australia
1056,47,Estonia,1,0,2,3,2000,Summer,Australia
1057,47,Thailand,1,0,2,3,2000,Summer,Australia
1058,49,Croatia,1,0,1,2,2000,Summer,Australia
1059,50,Cameroon,1,0,0,1,2000,Summer,Australia
1060,50,Colombia,1,0,0,1,2000,Summer,Australia
1061,50,Mozambique,1,0,0,1,2000,Summer,Australia
1062,53,Brazil,0,6,6,12,2000,Summer,Australia
1063,54,Jamaica,0,6,3,9,2000,Summer,Australia
1064,55,Belgium,0,2,3,5,2000,Summer,Australia
1065,55,South Africa,0,2,3,5,2000,Summer,Australia
1066,57,Argentina,0,2,2,4,2000,Summer,Australia
1067,58,Chinese Taipei,0,1,4,5,2000,Summer,Australia
1068,58,Morocco,0,1,4,5,2000,Summer,Australia
1069,60,North Korea,0,1,3,4,2000,Summer,Australia
1070,61,Moldova,0,1,1,2,2000,Summer,Australia
1071,61,Saudi Arabia,0,1,1,2,2000,Summer,Australia
1072,61,Trinidad And Tobago,0,1,1,2,2000,Summer,Australia
1073,64,Ireland,0,1,0,1,2000,Summer,Australia
1074,64,Sri Lanka,0,1,0,1,2000,Summer,Australia
1075,64,Uruguay,0,1,0,1,2000,Summer,Australia
1076,64,Vietnam,0,1,0,1,2000,Summer,Australia
1077,68,Georgia,0,0,6,6,2000,Summer,Australia
1078,69,Costa Rica,0,0,2,2,2000,Summer,Australia
1079,69,Portugal,0,0,2,2,2000,Summer,Australia
1080,71,Armenia,0,0,1,1,2000,Summer,Australia
1081,71,Barbados,0,0,1,1,2000,Summer,Australia
1082,71,Chile,0,0,1,1,2000,Summer,Australia
1083,71,Iceland,0,0,1,1,2000,Summer,Australia
1084,71,India,0,0,1,1,2000,Summer,Australia
1085,71,Israel,0,0,1,1,2000,Summer,Australia
1086,71,Kuwait,0,0,1,1,2000,Summer,Australia
1087,71,Kyrgyzstan,0,0,1,1,2000,Summer,Australia
1088,71,Macedonia,0,0,1,1,2000,Summer,Australia
1089,71,Qatar,0,0,1,1,2000,Summer,Australia
1090,1,Norway,13,5,7,25,2002,Winter,USA
1091,2,Germany,12,16,8,36,2002,Winter,USA
1092,3,United States,10,13,11,34,2002,Winter,USA
1093,4,Canada,7,3,7,17,2002,Winter,USA
1094,5,Russia,5,4,4,13,2002,Winter,USA
1095,6,France,4,5,2,11,2002,Winter,USA
1096,7,Italy,4,4,5,13,2002,Winter,USA
1097,8,Finland,4,2,1,7,2002,Winter,USA
1098,9,Netherlands,3,5,0,8,2002,Winter,USA
1099,10,Austria,3,4,10,17,2002,Winter,USA
1100,11,Switzerland,3,2,6,11,2002,Winter,USA
1101,12,Croatia,3,1,0,4,2002,Winter,USA
1102,13,China,2,2,4,8,2002,Winter,USA
1103,14,South Korea,2,2,0,4,2002,Winter,USA
1104,15,Australia,2,0,0,2,2002,Winter,USA
1105,16,Czech Republic,1,2,0,3,2002,Winter,USA
1106,17,Estonia,1,1,1,3,2002,Winter,USA
1107,18,Great Britain,1,0,1,2,2002,Winter,USA
1108,19,Sweden,0,2,5,7,2002,Winter,USA
1109,20,Bulgaria,0,1,2,3,2002,Winter,USA
1110,21,Japan,0,1,1,2,2002,Winter,USA
1111,21,Poland,0,1,1,2,2002,Winter,USA
1112,23,Belarus,0,0,1,1,2002,Winter,USA
1113,23,Slovenia,0,0,1,1,2002,Winter,USA
1114,1,United States,36,39,26,101,2004,Summer,Greece
1115,2,China,32,17,14,63,2004,Summer,Greece
1116,3,Russia,28,26,36,90,2004,Summer,Greece
1117,4,Australia,17,16,17,50,2004,Summer,Greece
1118,5,Japan,16,9,12,37,2004,Summer,Greece
1119,6,Germany,13,16,20,49,2004,Summer,Greece
1120,7,France,11,9,13,33,2004,Summer,Greece
1121,8,Italy,10,11,11,32,2004,Summer,Greece
1122,9,South Korea,9,12,9,30,2004,Summer,Greece
1123,10,Great Britain,9,9,12,30,2004,Summer,Greece
1124,11,Cuba,9,7,11,27,2004,Summer,Greece
1125,12,Hungary,8,6,3,17,2004,Summer,Greece
1126,13,Ukraine,8,5,9,22,2004,Summer,Greece
1127,14,Romania,8,5,6,19,2004,Summer,Greece
1128,15,Greece,6,6,4,16,2004,Summer,Greece
1129,16,Brazil,5,2,3,10,2004,Summer,Greece
1130,17,Norway,5,0,1,6,2004,Summer,Greece
1131,18,Netherlands,4,9,9,22,2004,Summer,Greece
1132,19,Sweden,4,2,1,7,2004,Summer,Greece
1133,20,Spain,3,11,6,20,2004,Summer,Greece
1134,21,Canada,3,6,3,12,2004,Summer,Greece
1135,22,Turkey,3,3,5,11,2004,Summer,Greece
1136,23,Poland,3,2,5,10,2004,Summer,Greece
1137,24,New Zealand,3,2,0,5,2004,Summer,Greece
1138,25,Thailand,3,1,4,8,2004,Summer,Greece
1139,26,Belarus,2,5,6,13,2004,Summer,Greece
1140,27,Austria,2,4,1,7,2004,Summer,Greece
1141,28,Ethiopia,2,3,2,7,2004,Summer,Greece
1142,29,Iran,2,2,2,6,2004,Summer,Greece
1143,29,Slovakia,2,2,2,6,2004,Summer,Greece
1144,31,Chinese Taipei,2,2,1,5,2004,Summer,Greece
1145,32,Georgia,2,2,0,4,2004,Summer,Greece
1146,33,Bulgaria,2,1,9,12,2004,Summer,Greece
1147,34,Denmark,2,1,5,8,2004,Summer,Greece
1148,35,Jamaica,2,1,2,5,2004,Summer,Greece
1149,35,Uzbekistan,2,1,2,5,2004,Summer,Greece
1150,37,Morocco,2,1,0,3,2004,Summer,Greece
1151,38,Argentina,2,0,4,6,2004,Summer,Greece
1152,39,Chile,2,0,1,3,2004,Summer,Greece
1153,40,Kazakhstan,1,4,3,8,2004,Summer,Greece
1154,41,Kenya,1,4,2,7,2004,Summer,Greece
1155,42,Czech Republic,1,3,5,9,2004,Summer,Greece
1156,43,South Africa,1,3,2,6,2004,Summer,Greece
1157,44,Croatia,1,2,2,5,2004,Summer,Greece
1158,45,Lithuania,1,2,0,3,2004,Summer,Greece
1159,46,Egypt,1,1,3,5,2004,Summer,Greece
1160,46,Switzerland,1,1,3,5,2004,Summer,Greece
1161,48,Indonesia,1,1,2,4,2004,Summer,Greece
1162,49,Zimbabwe,1,1,1,3,2004,Summer,Greece
1163,50,Azerbaijan,1,0,4,5,2004,Summer,Greece
1164,51,Belgium,1,0,2,3,2004,Summer,Greece
1165,52,Bahamas,1,0,1,2,2004,Summer,Greece
1166,52,Israel,1,0,1,2,2004,Summer,Greece
1167,54,Cameroon,1,0,0,1,2004,Summer,Greece
1168,54,Dominican Republic,1,0,0,1,2004,Summer,Greece
1169,54,United Arab Emirates,1,0,0,1,2004,Summer,Greece
1170,57,North Korea,0,4,1,5,2004,Summer,Greece
1171,58,Latvia,0,4,0,4,2004,Summer,Greece
1172,59,Mexico,0,3,1,4,2004,Summer,Greece
1173,60,Portugal,0,2,1,3,2004,Summer,Greece
1174,61,Finland,0,2,0,2,2004,Summer,Greece
1175,61,Serbia And Montenegro,0,2,0,2,2004,Summer,Greece
1176,63,Slovenia,0,1,3,4,2004,Summer,Greece
1177,64,Estonia,0,1,2,3,2004,Summer,Greece
1178,65,Hong Kong,0,1,0,1,2004,Summer,Greece
1179,65,India,0,1,0,1,2004,Summer,Greece
1180,65,Paraguay,0,1,0,1,2004,Summer,Greece
1181,68,Colombia,0,0,2,2,2004,Summer,Greece
1182,68,Nigeria,0,0,2,2,2004,Summer,Greece
1183,68,Venezuela,0,0,2,2,2004,Summer,Greece
1184,71,Eritrea,0,0,1,1,2004,Summer,Greece
1185,71,Mongolia,0,0,1,1,2004,Summer,Greece
1186,71,Syria,0,0,1,1,2004,Summer,Greece
1187,71,Trinidad And Tobago,0,0,1,1,2004,Summer,Greece
1188,1,Germany,11,12,6,29,2006,Winter,Italy
1189,2,United States,9,9,7,25,2006,Winter,Italy
1190,3,Austria,9,7,7,23,2006,Winter,Italy
1191,4,Russia,8,6,8,22,2006,Winter,Italy
1192,5,Canada,7,10,7,24,2006,Winter,Italy
1193,6,Sweden,7,2,5,14,2006,Winter,Italy
1194,7,South Korea,6,3,2,11,2006,Winter,Italy
1195,8,Switzerland,5,4,5,14,2006,Winter,Italy
1196,9,Italy,5,0,6,11,2006,Winter,Italy
1197,10,France,3,2,4,9,2006,Winter,Italy
1198,10,Netherlands,3,2,4,9,2006,Winter,Italy
1199,12,Estonia,3,0,0,3,2006,Winter,Italy
1200,13,Norway,2,8,9,19,2006,Winter,Italy
1201,14,China,2,4,5,11,2006,Winter,Italy
1202,15,Czech Republic,1,2,1,4,2006,Winter,Italy
1203,16,Croatia,1,2,0,3,2006,Winter,Italy
1204,17,Australia,1,0,1,2,2006,Winter,Italy
1205,18,Japan,1,0,0,1,2006,Winter,Italy
1206,19,Finland,0,6,3,9,2006,Winter,Italy
1207,20,Poland,0,1,1,2,2006,Winter,Italy
1208,21,Belarus,0,1,0,1,2006,Winter,Italy
1209,21,Bulgaria,0,1,0,1,2006,Winter,Italy
1210,21,Great Britain,0,1,0,1,2006,Winter,Italy
1211,21,Slovakia,0,1,0,1,2006,Winter,Italy
1212,25,Ukraine,0,0,2,2,2006,Winter,Italy
1213,26,Latvia,0,0,1,1,2006,Winter,Italy
1214,1,China,48,22,30,100,2008,Summer,China
1215,2,United States,36,39,37,112,2008,Summer,China
1216,3,Russia,24,13,23,60,2008,Summer,China
1217,4,Great Britain,19,13,19,51,2008,Summer,China
1218,5,Germany,16,11,14,41,2008,Summer,China
1219,6,Australia,14,15,17,46,2008,Summer,China
1220,7,South Korea,13,11,8,32,2008,Summer,China
1221,8,Japan,9,8,8,25,2008,Summer,China
1222,9,Italy,8,9,10,27,2008,Summer,China
1223,10,France,7,16,20,43,2008,Summer,China
1224,11,Netherlands,7,5,4,16,2008,Summer,China
1225,12,Ukraine,7,4,11,22,2008,Summer,China
1226,13,Kenya,6,4,6,16,2008,Summer,China
1227,14,Spain,5,11,3,19,2008,Summer,China
1228,15,Jamaica,5,4,2,11,2008,Summer,China
1229,16,Poland,4,5,2,11,2008,Summer,China
1230,17,Ethiopia,4,2,1,7,2008,Summer,China
1231,18,Romania,4,1,4,9,2008,Summer,China
1232,19,Cuba,3,10,17,30,2008,Summer,China
1233,20,Canada,3,9,8,20,2008,Summer,China
1234,21,Hungary,3,5,2,10,2008,Summer,China
1235,22,Norway,3,5,1,9,2008,Summer,China
1236,23,Brazil,3,4,10,17,2008,Summer,China
1237,24,Belarus,3,4,7,14,2008,Summer,China
1238,25,Czech Republic,3,3,1,7,2008,Summer,China
1239,26,Slovakia,3,3,0,6,2008,Summer,China
1240,27,New Zealand,3,2,4,9,2008,Summer,China
1241,28,Georgia,3,2,2,7,2008,Summer,China
1242,29,Kazakhstan,2,3,4,9,2008,Summer,China
1243,30,Denmark,2,2,3,7,2008,Summer,China
1244,31,North Korea,2,2,2,6,2008,Summer,China
1245,31,Thailand,2,2,2,6,2008,Summer,China
1246,33,Mongolia,2,2,0,4,2008,Summer,China
1247,34,Switzerland,2,1,4,7,2008,Summer,China
1248,35,Argentina,2,0,4,6,2008,Summer,China
1249,36,Mexico,2,0,2,4,2008,Summer,China
1250,37,Belgium,2,0,0,2,2008,Summer,China
1251,38,Zimbabwe,1,3,0,4,2008,Summer,China
1252,39,Slovenia,1,2,2,5,2008,Summer,China
1253,40,Azerbaijan,1,1,4,6,2008,Summer,China
1254,40,Indonesia,1,1,4,6,2008,Summer,China
1255,42,Bulgaria,1,1,3,5,2008,Summer,China
1256,42,Turkey,1,1,3,5,2008,Summer,China
1257,44,Chinese Taipei,1,1,2,4,2008,Summer,China
1258,44,Finland,1,1,2,4,2008,Summer,China
1259,46,Latvia,1,1,1,3,2008,Summer,China
1260,47,Dominican Republic,1,1,0,2,2008,Summer,China
1261,47,Estonia,1,1,0,2,2008,Summer,China
1262,47,Portugal,1,1,0,2,2008,Summer,China
1263,47,Trinidad And Tobago,1,1,0,2,2008,Summer,China
1264,51,India,1,0,2,3,2008,Summer,China
1265,52,Iran,1,0,1,2,2008,Summer,China
1266,53,Cameroon,1,0,0,1,2008,Summer,China
1267,53,Panama,1,0,0,1,2008,Summer,China
1268,53,Tunisia,1,0,0,1,2008,Summer,China
1269,56,Sweden,0,4,1,5,2008,Summer,China
1270,57,Lithuania,0,3,2,5,2008,Summer,China
1271,57,Nigeria,0,3,2,5,2008,Summer,China
1272,59,Croatia,0,2,3,5,2008,Summer,China
1273,60,Colombia,0,2,1,3,2008,Summer,China
1274,60,Greece,0,2,1,3,2008,Summer,China
1275,62,Armenia,0,1,4,5,2008,Summer,China
1276,63,Uzbekistan,0,1,3,4,2008,Summer,China
1277,64,Austria,0,1,2,3,2008,Summer,China
1278,64,Ireland,0,1,2,3,2008,Summer,China
1279,64,Kyrgyzstan,0,1,2,3,2008,Summer,China
1280,64,Serbia,0,1,2,3,2008,Summer,China
1281,68,Algeria,0,1,1,2,2008,Summer,China
1282,68,Bahamas,0,1,1,2,2008,Summer,China
1283,68,Morocco,0,1,1,2,2008,Summer,China
1284,68,Tajikistan,0,1,1,2,2008,Summer,China
1285,72,Chile,0,1,0,1,2008,Summer,China
1286,72,Ecuador,0,1,0,1,2008,Summer,China
1287,72,Iceland,0,1,0,1,2008,Summer,China
1288,72,Malaysia,0,1,0,1,2008,Summer,China
1289,72,Samoa,0,1,0,1,2008,Summer,China
1290,72,Singapore,0,1,0,1,2008,Summer,China
1291,72,South Africa,0,1,0,1,2008,Summer,China
1292,72,Sudan,0,1,0,1,2008,Summer,China
1293,72,Vietnam,0,1,0,1,2008,Summer,China
1294,81,Egypt,0,0,2,2,2008,Summer,China
1295,82,Afghanistan,0,0,1,1,2008,Summer,China
1296,82,Israel,0,0,1,1,2008,Summer,China
1297,82,Mauritius,0,0,1,1,2008,Summer,China
1298,82,Moldova,0,0,1,1,2008,Summer,China
1299,82,Togo,0,0,1,1,2008,Summer,China
1300,82,Venezuela,0,0,1,1,2008,Summer,China
1301,1,Canada,14,7,5,26,2010,Winter,Canada
1302,2,Germany,10,13,7,30,2010,Winter,Canada
1303,3,United States,9,15,13,37,2010,Winter,Canada
1304,4,Norway,9,8,6,23,2010,Winter,Canada
1305,5,South Korea,6,6,2,14,2010,Winter,Canada
1306,6,Switzerland,6,0,3,9,2010,Winter,Canada
1307,7,China,5,2,4,11,2010,Winter,Canada
1308,7,Sweden,5,2,4,11,2010,Winter,Canada
1309,9,Austria,4,6,6,16,2010,Winter,Canada
1310,10,Netherlands,4,1,3,8,2010,Winter,Canada
1311,11,Russia,3,5,7,15,2010,Winter,Canada
1312,12,France,2,3,6,11,2010,Winter,Canada
1313,13,Australia,2,1,0,3,2010,Winter,Canada
1314,14,Czech Republic,2,0,4,6,2010,Winter,Canada
1315,15,Poland,1,3,2,6,2010,Winter,Canada
1316,16,Italy,1,1,3,5,2010,Winter,Canada
1317,17,Belarus,1,1,1,3,2010,Winter,Canada
1318,17,Slovakia,1,1,1,3,2010,Winter,Canada
1319,19,Great Britain,1,0,0,1,2010,Winter,Canada
1320,20,Japan,0,3,2,5,2010,Winter,Canada
1321,21,Croatia,0,2,1,3,2010,Winter,Canada
1322,21,Slovenia,0,2,1,3,2010,Winter,Canada
1323,23,Latvia,0,2,0,2,2010,Winter,Canada
1324,24,Finland,0,1,4,5,2010,Winter,Canada
1325,25,Estonia,0,1,0,1,2010,Winter,Canada
1326,25,Kazakhstan,0,1,0,1,2010,Winter,Canada
1327,1,United States,47,27,30,104,2012,Summer,England
1328,2,China,38,31,22,91,2012,Summer,England
1329,3,Great Britain,29,18,18,65,2012,Summer,England
1330,4,Russia,20,21,27,68,2012,Summer,England
1331,5,South Korea,13,9,8,30,2012,Summer,England
1332,6,Germany,11,20,13,44,2012,Summer,England
1333,7,France,11,11,13,35,2012,Summer,England
1334,8,Australia,8,15,12,35,2012,Summer,England
1335,9,Italy,8,9,11,28,2012,Summer,England
1336,10,Hungary,8,4,6,18,2012,Summer,England
1337,11,Japan,7,14,17,38,2012,Summer,England
1338,12,Iran,7,5,1,13,2012,Summer,England
1339,13,Netherlands,6,6,8,20,2012,Summer,England
1340,14,New Zealand,6,2,5,13,2012,Summer,England
1341,15,Ukraine,5,4,10,19,2012,Summer,England
1342,16,Cuba,5,3,7,15,2012,Summer,England
1343,17,Spain,4,10,6,20,2012,Summer,England
1344,18,Jamaica,4,5,3,12,2012,Summer,England
1345,19,Czech Republic,4,3,4,11,2012,Summer,England
1346,20,South Africa,4,1,1,6,2012,Summer,England
1347,21,North Korea,4,0,3,7,2012,Summer,England
1348,22,Brazil,3,5,9,17,2012,Summer,England
1349,23,Kazakhstan,3,2,6,11,2012,Summer,England
1350,23,Poland,3,2,6,11,2012,Summer,England
1351,25,Ethiopia,3,2,3,8,2012,Summer,England
1352,26,Croatia,3,1,2,6,2012,Summer,England
1353,27,Canada,2,6,10,18,2012,Summer,England
1354,28,Belarus,2,5,3,10,2012,Summer,England
1355,29,Kenya,2,4,7,13,2012,Summer,England
1356,30,Denmark,2,4,3,9,2012,Summer,England
1357,31,Romania,2,4,1,7,2012,Summer,England
1358,32,Azerbaijan,2,2,5,9,2012,Summer,England
1359,33,Switzerland,2,2,0,4,2012,Summer,England
1360,34,Norway,2,1,1,4,2012,Summer,England
1361,35,Lithuania,2,0,3,5,2012,Summer,England
1362,36,Tunisia,2,0,1,3,2012,Summer,England
1363,37,Sweden,1,4,3,8,2012,Summer,England
1364,38,Colombia,1,3,5,9,2012,Summer,England
1365,39,Mexico,1,3,4,8,2012,Summer,England
1366,40,Georgia,1,2,3,6,2012,Summer,England
1367,41,Ireland,1,1,4,6,2012,Summer,England
1368,42,Argentina,1,1,2,4,2012,Summer,England
1369,42,Serbia,1,1,2,4,2012,Summer,England
1370,42,Slovenia,1,1,2,4,2012,Summer,England
1371,42,Trinidad And Tobago,1,1,2,4,2012,Summer,England
1372,46,Turkey,1,1,1,3,2012,Summer,England
1373,47,Dominican Republic,1,1,0,2,2012,Summer,England
1374,48,Chinese Taipei,1,0,1,2,2012,Summer,England
1375,48,Latvia,1,0,1,2,2012,Summer,England
1376,50,Algeria,1,0,0,1,2012,Summer,England
1377,50,Bahamas,1,0,0,1,2012,Summer,England
1378,50,Bahrain,1,0,0,1,2012,Summer,England
1379,50,Grenada,1,0,0,1,2012,Summer,England
1380,50,Uganda,1,0,0,1,2012,Summer,England
1381,50,Venezuela,1,0,0,1,2012,Summer,England
1382,56,Egypt,0,3,1,4,2012,Summer,England
1383,57,India,0,2,4,6,2012,Summer,England
1384,58,Mongolia,0,2,3,5,2012,Summer,England
1385,59,Thailand,0,2,2,4,2012,Summer,England
1386,60,Bulgaria,0,2,1,3,2012,Summer,England
1387,60,Finland,0,2,1,3,2012,Summer,England
1388,60,Indonesia,0,2,1,3,2012,Summer,England
1389,63,Slovakia,0,1,3,4,2012,Summer,England
1390,64,Belgium,0,1,2,3,2012,Summer,England
1391,65,Armenia,0,1,1,2,2012,Summer,England
1392,65,Estonia,0,1,1,2,2012,Summer,England
1393,65,Malaysia,0,1,1,2,2012,Summer,England
1394,65,Puerto Rico,0,1,1,2,2012,Summer,England
1395,65,Qatar,0,1,1,2,2012,Summer,England
1396,70,Botswana,0,1,0,1,2012,Summer,England
1397,70,Cyprus,0,1,0,1,2012,Summer,England
1398,70,Gabon,0,1,0,1,2012,Summer,England
1399,70,Guatemala,0,1,0,1,2012,Summer,England
1400,70,Montenegro,0,1,0,1,2012,Summer,England
1401,70,Portugal,0,1,0,1,2012,Summer,England
1402,76,Uzbekistan,0,0,3,3,2012,Summer,England
1403,77,Greece,0,0,2,2,2012,Summer,England
1404,77,Singapore,0,0,2,2,2012,Summer,England
1405,79,Afghanistan,0,0,1,1,2012,Summer,England
1406,79,Cameroon,0,0,1,1,2012,Summer,England
1407,79,Hong Kong,0,0,1,1,2012,Summer,England
1408,79,Kuwait,0,0,1,1,2012,Summer,England
1409,79,Morocco,0,0,1,1,2012,Summer,England
1410,79,Saudi Arabia,0,0,1,1,2012,Summer,England
1411,79,Tajikistan,0,0,1,1,2012,Summer,England
1412,79,Vietnam,0,0,1,1,2012,Summer,England
1413,1,Russia,11,9,9,29,2014,Winter,Russia
1414,2,Norway,11,5,10,26,2014,Winter,Russia
1415,3,Canada,10,10,5,25,2014,Winter,Russia
1416,4,United States,9,9,10,28,2014,Winter,Russia
1417,5,Netherlands,8,7,9,24,2014,Winter,Russia
1418,6,Germany,8,6,5,19,2014,Winter,Russia
1419,7,Switzerland,7,2,2,11,2014,Winter,Russia
1420,8,Belarus,5,0,1,6,2014,Winter,Russia
1421,9,Austria,4,8,5,17,2014,Winter,Russia
1422,10,France,4,4,7,15,2014,Winter,Russia
1423,11,Poland,4,1,1,6,2014,Winter,Russia
1424,12,China,3,4,2,9,2014,Winter,Russia
1425,13,South Korea,3,3,2,8,2014,Winter,Russia
1426,14,Sweden,2,7,6,15,2014,Winter,Russia
1427,15,Czech Republic,2,4,2,8,2014,Winter,Russia
1428,16,Slovenia,2,2,4,8,2014,Winter,Russia
1429,17,Japan,1,4,3,8,2014,Winter,Russia
1430,18,Finland,1,3,1,5,2014,Winter,Russia
1431,19,Great Britain,1,1,3,5,2014,Winter,Russia
1432,19,Latvia,1,1,3,5,2014,Winter,Russia
1433,21,Ukraine,1,0,1,2,2014,Winter,Russia
1434,22,Slovakia,1,0,0,1,2014,Winter,Russia
1435,23,Italy,0,2,6,8,2014,Winter,Russia
1436,24,Australia,0,2,1,3,2014,Winter,Russia
1437,25,Croatia,0,1,0,1,2014,Winter,Russia
1438,26,Kazakhstan,0,0,1,1,2014,Winter,Russia
1439,1,United States,46,37,38,121,2016,Summer,Brazil
1440,2,Great Britain,27,23,17,67,2016,Summer,Brazil
1441,3,China,26,18,26,70,2016,Summer,Brazil
1442,4,Russia,19,17,20,56,2016,Summer,Brazil
1443,5,Germany,17,10,15,42,2016,Summer,Brazil
1444,6,Japan,12,8,21,41,2016,Summer,Brazil
1445,7,France,10,18,14,42,2016,Summer,Brazil
1446,8,South Korea,9,3,9,21,2016,Summer,Brazil
1447,9,Italy,8,12,8,28,2016,Summer,Brazil
1448,10,Australia,8,11,10,29,2016,Summer,Brazil
1449,11,Netherlands,8,7,4,19,2016,Summer,Brazil
1450,12,Hungary,8,3,4,15,2016,Summer,Brazil
1451,13,Brazil,7,6,6,19,2016,Summer,Brazil
1452,14,Spain,7,4,6,17,2016,Summer,Brazil
1453,15,Kenya,6,6,1,13,2016,Summer,Brazil
1454,16,Jamaica,6,3,2,11,2016,Summer,Brazil
1455,17,Croatia,5,3,2,10,2016,Summer,Brazil
1456,18,Cuba,5,2,4,11,2016,Summer,Brazil
1457,19,New Zealand,4,9,5,18,2016,Summer,Brazil
1458,20,Canada,4,3,15,22,2016,Summer,Brazil
1459,21,Uzbekistan,4,2,7,13,2016,Summer,Brazil
1460,22,Kazakhstan,3,5,10,18,2016,Summer,Brazil
1461,23,Colombia,3,2,3,8,2016,Summer,Brazil
1462,24,Switzerland,3,2,2,7,2016,Summer,Brazil
1463,25,Iran,3,1,4,8,2016,Summer,Brazil
1464,26,Greece,3,1,2,6,2016,Summer,Brazil
1465,27,Argentina,3,1,0,4,2016,Summer,Brazil
1466,28,Denmark,2,6,7,15,2016,Summer,Brazil
1467,29,Sweden,2,6,3,11,2016,Summer,Brazil
1468,30,South Africa,2,6,2,10,2016,Summer,Brazil
1469,31,Ukraine,2,5,4,11,2016,Summer,Brazil
1470,32,Serbia,2,4,2,8,2016,Summer,Brazil
1471,33,Poland,2,3,6,11,2016,Summer,Brazil
1472,34,North Korea,2,3,2,7,2016,Summer,Brazil
1473,35,Belgium,2,2,2,6,2016,Summer,Brazil
1474,35,Thailand,2,2,2,6,2016,Summer,Brazil
1475,37,Slovakia,2,2,0,4,2016,Summer,Brazil
1476,38,Georgia,2,1,4,7,2016,Summer,Brazil
1477,39,Azerbaijan,1,7,10,18,2016,Summer,Brazil
1478,40,Belarus,1,4,4,9,2016,Summer,Brazil
1479,41,Turkey,1,3,4,8,2016,Summer,Brazil
1480,42,Armenia,1,3,0,4,2016,Summer,Brazil
1481,43,Czech Republic,1,2,7,10,2016,Summer,Brazil
1482,44,Ethiopia,1,2,5,8,2016,Summer,Brazil
1483,45,Slovenia,1,2,1,4,2016,Summer,Brazil
1484,46,Indonesia,1,2,0,3,2016,Summer,Brazil
1485,47,Romania,1,1,2,4,2016,Summer,Brazil
1486,48,Bahrain,1,1,0,2,2016,Summer,Brazil
1487,48,Vietnam,1,1,0,2,2016,Summer,Brazil
1488,50,Chinese Taipei,1,0,2,3,2016,Summer,Brazil
1489,51,Bahamas,1,0,1,2,2016,Summer,Brazil
1490,51,Independent Olympic Athletes,1,0,1,2,2016,Summer,Brazil
1491,51,Ivory Coast,1,0,1,2,2016,Summer,Brazil
1492,54,Fiji,1,0,0,1,2016,Summer,Brazil
1493,54,Jordan,1,0,0,1,2016,Summer,Brazil
1494,54,Kosovo,1,0,0,1,2016,Summer,Brazil
1495,54,Puerto Rico,1,0,0,1,2016,Summer,Brazil
1496,54,Singapore,1,0,0,1,2016,Summer,Brazil
1497,54,Tajikistan,1,0,0,1,2016,Summer,Brazil
1498,60,Malaysia,0,4,1,5,2016,Summer,Brazil
1499,61,Mexico,0,3,2,5,2016,Summer,Brazil
1500,62,Venezuela,0,2,1,3,2016,Summer,Brazil
1501,63,Algeria,0,2,0,2,2016,Summer,Brazil
1502,63,Ireland,0,2,0,2,2016,Summer,Brazil
1503,65,Lithuania,0,1,3,4,2016,Summer,Brazil
1504,66,Bulgaria,0,1,2,3,2016,Summer,Brazil
1505,67,India,0,1,1,2,2016,Summer,Brazil
1506,67,Mongolia,0,1,1,2,2016,Summer,Brazil
1507,69,Burundi,0,1,0,1,2016,Summer,Brazil
1508,69,Grenada,0,1,0,1,2016,Summer,Brazil
1509,69,Niger,0,1,0,1,2016,Summer,Brazil
1510,69,Philippines,0,1,0,1,2016,Summer,Brazil
1511,69,Qatar,0,1,0,1,2016,Summer,Brazil
1512,74,Norway,0,0,4,4,2016,Summer,Brazil
1513,75,Egypt,0,0,3,3,2016,Summer,Brazil
1514,75,Tunisia,0,0,3,3,2016,Summer,Brazil
1515,77,Israel,0,0,2,2,2016,Summer,Brazil
1516,78,Austria,0,0,1,1,2016,Summer,Brazil
1517,78,Dominican Republic,0,0,1,1,2016,Summer,Brazil
1518,78,Estonia,0,0,1,1,2016,Summer,Brazil
1519,78,Finland,0,0,1,1,2016,Summer,Brazil
1520,78,Morocco,0,0,1,1,2016,Summer,Brazil
1521,78,Nigeria,0,0,1,1,2016,Summer,Brazil
1522,78,Portugal,0,0,1,1,2016,Summer,Brazil
1523,78,Trinidad And Tobago,0,0,1,1,2016,Summer,Brazil
1524,78,United Arab Emirates,0,0,1,1,2016,Summer,Brazil
1525,1,Norway,14,14,11,39,2018,Winter,South Korea
1526,2,Germany,14,10,7,31,2018,Winter,South Korea
1527,3,Canada,11,8,10,29,2018,Winter,South Korea
1528,4,United States,9,8,6,23,2018,Winter,South Korea
1529,5,Netherlands,8,6,6,20,2018,Winter,South Korea
1530,6,Sweden,7,6,1,14,2018,Winter,South Korea
1531,7,South Korea,5,8,4,17,2018,Winter,South Korea
1532,8,Switzerland,5,6,4,15,2018,Winter,South Korea
1533,9,France,5,4,6,15,2018,Winter,South Korea
1534,10,Austria,5,3,6,14,2018,Winter,South Korea
1535,11,Japan,4,5,4,13,2018,Winter,South Korea
1536,12,Italy,3,2,5,10,2018,Winter,South Korea
1537,13,Olympic Athletes From Russia,2,6,9,17,2018,Winter,South Korea
1538,14,Czech Republic,2,2,3,7,2018,Winter,South Korea
1539,15,Belarus,2,1,0,3,2018,Winter,South Korea
1540,16,China,1,6,2,9,2018,Winter,South Korea
1541,17,Slovakia,1,2,0,3,2018,Winter,South Korea
1542,18,Finland,1,1,4,6,2018,Winter,South Korea
1543,19,Great Britain,1,0,4,5,2018,Winter,South Korea
1544,20,Poland,1,0,1,2,2018,Winter,South Korea
1545,21,Hungary,1,0,0,1,2018,Winter,South Korea
1546,21,Ukraine,1,0,0,1,2018,Winter,South Korea
1547,23,Australia,0,2,1,3,2018,Winter,South Korea
1548,24,Slovenia,0,1,1,2,2018,Winter,South Korea
1549,25,Belgium,0,1,0,1,2018,Winter,South Korea
1550,26,New Zealand,0,0,2,2,2018,Winter,South Korea
1551,26,Spain,0,0,2,2,2018,Winter,South Korea
1552,28,Kazakhstan,0,0,1,1,2018,Winter,South Korea
1553,28,Latvia,0,0,1,1,2018,Winter,South Korea
1554,28,Liechtenstein,0,0,1,1,2018,Winter,South Korea
1555,1,United States,39,41,33,113,2020,Summer,Japan
1556,2,China,38,32,18,88,2020,Summer,Japan
1557,3,Japan,27,14,17,58,2020,Summer,Japan
1558,4,Great Britain,22,21,22,65,2020,Summer,Japan
1559,5,Russia,20,28,23,71,2020,Summer,Japan
1560,6,Australia,17,7,22,46,2020,Summer,Japan
1561,7,Netherlands,10,12,14,36,2020,Summer,Japan
1562,8,France,10,12,11,33,2020,Summer,Japan
1563,9,Germany,10,11,16,37,2020,Summer,Japan
1564,10,Italy,10,10,20,40,2020,Summer,Japan
1565,11,Canada,7,6,11,24,2020,Summer,Japan
1566,12,Brazil,7,6,8,21,2020,Summer,Japan
1567,13,New Zealand,7,6,7,20,2020,Summer,Japan
1568,14,Cuba,7,3,5,15,2020,Summer,Japan
1569,15,Hungary,6,7,7,20,2020,Summer,Japan
1570,16,South Korea,6,4,10,20,2020,Summer,Japan
1571,17,Poland,4,5,5,14,2020,Summer,Japan
1572,18,Czech Republic,4,4,3,11,2020,Summer,Japan
1573,19,Kenya,4,4,2,10,2020,Summer,Japan
1574,20,Norway,4,2,2,8,2020,Summer,Japan
1575,21,Jamaica,4,1,4,9,2020,Summer,Japan
1576,22,Spain,3,8,6,17,2020,Summer,Japan
1577,23,Sweden,3,6,0,9,2020,Summer,Japan
1578,24,Switzerland,3,4,6,13,2020,Summer,Japan
1579,25,Denmark,3,4,4,11,2020,Summer,Japan
1580,26,Croatia,3,3,2,8,2020,Summer,Japan
1581,27,Iran,3,2,2,7,2020,Summer,Japan
1582,28,Serbia,3,1,5,9,2020,Summer,Japan
1583,29,Belgium,3,1,3,7,2020,Summer,Japan
1584,30,Bulgaria,3,1,2,6,2020,Summer,Japan
1585,31,Slovenia,3,1,1,5,2020,Summer,Japan
1586,32,Uzbekistan,3,0,2,5,2020,Summer,Japan
1587,33,Georgia,2,5,1,8,2020,Summer,Japan
1588,34,Chinese Taipei,2,4,6,12,2020,Summer,Japan
1589,35,Turkey,2,2,9,13,2020,Summer,Japan
1590,36,Greece,2,1,1,4,2020,Summer,Japan
1591,36,Uganda,2,1,1,4,2020,Summer,Japan
1592,38,Ecuador,2,1,0,3,2020,Summer,Japan
1593,39,Ireland,2,0,2,4,2020,Summer,Japan
1594,39,Israel,2,0,2,4,2020,Summer,Japan
1595,41,Qatar,2,0,1,3,2020,Summer,Japan
1596,42,Bahamas,2,0,0,2,2020,Summer,Japan
1597,42,Kosovo,2,0,0,2,2020,Summer,Japan
1598,44,Ukraine,1,6,12,19,2020,Summer,Japan
1599,45,Belarus,1,3,3,7,2020,Summer,Japan
1600,46,Romania,1,3,0,4,2020,Summer,Japan
1601,46,Venezuela,1,3,0,4,2020,Summer,Japan
1602,48,India,1,2,4,7,2020,Summer,Japan
1603,49,Hong Kong,1,2,3,6,2020,Summer,Japan
1604,50,Philippines,1,2,1,4,2020,Summer,Japan
1605,50,Slovakia,1,2,1,4,2020,Summer,Japan
1606,52,South Africa,1,2,0,3,2020,Summer,Japan
1607,53,Austria,1,1,5,7,2020,Summer,Japan
1608,54,Egypt,1,1,4,6,2020,Summer,Japan
1609,55,Indonesia,1,1,3,5,2020,Summer,Japan
1610,56,Ethiopia,1,1,2,4,2020,Summer,Japan
1611,56,Portugal,1,1,2,4,2020,Summer,Japan
1612,58,Tunisia,1,1,0,2,2020,Summer,Japan
1613,59,Estonia,1,0,1,2,2020,Summer,Japan
1614,59,Fiji,1,0,1,2,2020,Summer,Japan
1615,59,Latvia,1,0,1,2,2020,Summer,Japan
1616,59,Thailand,1,0,1,2,2020,Summer,Japan
1617,63,Bermuda,1,0,0,1,2020,Summer,Japan
1618,63,Morocco,1,0,0,1,2020,Summer,Japan
1619,63,Puerto Rico,1,0,0,1,2020,Summer,Japan
1620,66,Colombia,0,4,1,5,2020,Summer,Japan
1621,67,Azerbaijan,0,3,4,7,2020,Summer,Japan
1622,68,Dominican Republic,0,3,2,5,2020,Summer,Japan
1623,69,Armenia,0,2,2,4,2020,Summer,Japan
1624,70,Kyrgyzstan,0,2,1,3,2020,Summer,Japan
1625,71,Mongolia,0,1,3,4,2020,Summer,Japan
1626,72,Argentina,0,1,2,3,2020,Summer,Japan
1627,72,San Marino,0,1,2,3,2020,Summer,Japan
1628,74,Jordan,0,1,1,2,2020,Summer,Japan
1629,74,Malaysia,0,1,1,2,2020,Summer,Japan
1630,74,Nigeria,0,1,1,2,2020,Summer,Japan
1631,77,Bahrain,0,1,0,1,2020,Summer,Japan
1632,77,Lithuania,0,1,0,1,2020,Summer,Japan
1633,77,Namibia,0,1,0,1,2020,Summer,Japan
1634,77,North Macedonia,0,1,0,1,2020,Summer,Japan
1635,77,Saudi Arabia,0,1,0,1,2020,Summer,Japan
1636,77,Turkmenistan,0,1,0,1,2020,Summer,Japan
1637,83,Kazakhstan,0,0,8,8,2020,Summer,Japan
1638,84,Mexico,0,0,4,4,2020,Summer,Japan
1639,85,Finland,0,0,2,2,2020,Summer,Japan
1640,86,Botswana,0,0,1,1,2020,Summer,Japan
1641,86,Burkina Faso,0,0,1,1,2020,Summer,Japan
1642,86,Ghana,0,0,1,1,2020,Summer,Japan
1643,86,Grenada,0,0,1,1,2020,Summer,Japan
1644,86,Ivory Coast,0,0,1,1,2020,Summer,Japan
1645,86,Kuwait,0,0,1,1,2020,Summer,Japan
1646,86,Moldova,0,0,1,1,2020,Summer,Japan
1647,86,Syria,0,0,1,1,2020,Summer,Japan
